id_partido,equipo,minutos,puntos,T2 encestados,T2 totales,% T2,T3 encestados,T3 totales,% T3,TC encestados,TC totales,% TC,TL encestados,TL totales,% TL,rebotes_ofensivos,rebotes_defensivos,rebotes_totales,asistencias,recuperaciones,perdidas,tapones_favor,tapones_contra,mates,faltas_cometidas,faltas_recibidas,valoracion
2341452,HLA ALICANTE,200:00,92,25,46,54.3,9,22,40.9,34,68,50.0,15,21,71.4,11,18,29,21,12,12,4,4,6,25,20,101
2341452,RIOVERDE CLAVIJO,200:00,56,15,35,42.9,4,20,20.0,19,55,34.5,14,20,70.0,13,21,34,16,8,25,4,4,2,20,25,56
2341453,HESTIA MENORCA,200:00,66,15,24,62.5,9,33,27.3,24,57,42.1,9,16,56.3,5,15,20,7,2,9,3,2,0,20,18,47
2341453,MELILLA CIUDAD DEL DEPORTE,175:11,66,23,39,59.0,5,17,29.4,28,56,50.0,5,10,50.0,7,20,27,13,6,7,2,2,0,16,15,73
2341454,GRUPO URETA TIZONA BURGOS,200:00,92,20,36,55.6,10,31,32.3,30,67,44.8,22,28,78.6,10,17,27,11,7,10,0,1,2,30,34,88
2341454,UEMC REAL VALLADOLID BALONCESTO,200:00,86,21,36,58.3,7,17,41.2,28,53,52.8,23,29,79.3,6,28,34,11,8,20,1,0,3,34,30,85
2341455,CACERES PATRIMONIO DE LA HUMANIDAD,200:00,60,17,39,43.6,2,18,11.1,19,57,33.3,20,31,64.5,9,26,35,7,5,12,0,1,1,21,24,49
2341455,MOVISTAR ESTUDIANTES,200:00,83,17,41,41.5,12,23,52.2,29,64,45.3,13,24,54.2,8,27,35,13,8,10,1,0,1,24,21,81
2341456,ICG FORÇA LLEIDA,200:00,75,19,40,47.5,7,29,24.1,26,69,37.7,16,20,80.0,13,26,39,11,8,8,2,5,3,18,20,82
2341456,GUUK GIPUZKOA BASKET,200:00,68,15,34,44.1,10,28,35.7,25,62,40.3,8,16,50.0,10,27,37,18,5,13,5,2,1,20,18,73
2341457,BALONCESTO FUENLABRADA,200:00,73,14,39,35.9,12,20,60.0,26,59,44.1,9,13,69.2,11,24,35,12,1,14,0,4,2,21,19,68
2341457,GRUPO ALEGA CANTABRIA,200:00,78,24,44,54.5,7,24,29.2,31,68,45.6,9,15,60.0,8,19,27,15,6,4,4,0,0,19,21,85
2341458,CLUB OURENSE BALONCESTO,200:00,93,25,48,52.1,10,25,40.0,35,73,47.9,13,20,65.0,15,20,35,21,6,8,2,1,2,15,18,107
2341458,AMICS CASTELLÓ,200:00,80,22,42,52.4,8,16,50.0,30,58,51.7,12,15,80.0,6,20,26,17,5,12,1,2,1,18,15,83
2341459,ALIMERKA OVIEDO BALONCESTO,225:00,75,21,47,44.7,5,25,20.0,26,72,36.1,18,24,75.0,11,37,48,26,2,15,4,3,5,25,25,88
2341459,LONGEVIDA SAN PABLO BURGOS,225:00,71,17,37,45.9,8,33,24.2,25,70,35.7,13,21,61.9,5,31,36,20,7,11,3,4,4,25,24,72
2341460,REAL BETIS BALONCESTO,200:00,77,21,39,53.8,7,31,22.6,28,70,40.0,14,17,82.4,11,22,33,17,8,12,2,4,2,21,19,78
2341460,LEYMA CORUÑA,200:00,81,25,48,52.1,6,19,31.6,31,67,46.3,13,17,76.5,10,29,39,22,4,12,4,2,2,20,21,99
2341461,LONGEVIDA SAN PABLO BURGOS,200:00,79,16,28,57.1,9,29,31.0,25,57,43.9,20,26,76.9,8,28,36,21,7,15,1,2,2,23,23,91
2341461,ICG FORÇA LLEIDA,200:00,66,14,34,41.2,6,25,24.0,20,59,33.9,20,26,76.9,8,19,27,13,8,9,2,1,2,23,23,62
2341462,AMICS CASTELLÓ,200:00,90,24,49,49.0,7,21,33.3,31,70,44.3,21,28,75.0,10,26,36,21,6,10,1,2,0,21,24,101
2341462,CACERES PATRIMONIO DE LA HUMANIDAD,200:00,86,19,42,45.2,11,29,37.9,30,71,42.3,15,22,68.2,13,22,35,14,7,15,2,1,0,25,21,77
2341463,LEYMA CORUÑA,200:00,79,21,38,55.3,8,24,33.3,29,62,46.8,13,20,65.0,12,25,37,11,8,16,2,4,1,16,22,87
2341463,HLA ALICANTE,200:00,74,10,30,33.3,14,40,35.0,24,70,34.3,12,14,85.7,15,19,34,13,9,14,4,2,1,22,15,65
2341464,GUUK GIPUZKOA BASKET,200:00,76,18,38,47.4,6,15,40.0,24,53,45.3,22,26,84.6,6,22,28,12,4,14,0,1,1,25,24,72
2341464,GRUPO URETA TIZONA BURGOS,200:00,74,21,38,55.3,6,21,28.6,27,59,45.8,14,17,82.4,5,18,23,5,4,11,1,0,1,24,25,62
2341465,RIOVERDE CLAVIJO,200:00,62,15,29,51.7,6,24,25.0,21,53,39.6,14,21,66.7,7,20,27,14,5,19,4,0,2,32,22,44
2341465,REAL BETIS BALONCESTO,200:00,56,13,29,44.8,4,22,18.2,17,51,33.3,18,36,50.0,9,22,31,4,7,18,0,4,0,22,32,38
2341466,MOVISTAR ESTUDIANTES,200:00,76,20,42,47.6,5,15,33.3,25,57,43.9,21,27,77.8,9,17,26,10,5,9,2,3,0,20,28,80
2341466,ALIMERKA OVIEDO BALONCESTO,200:00,87,16,28,57.1,14,28,50.0,30,56,53.6,13,20,65.0,8,24,32,15,2,10,3,2,0,28,20,88
2341467,GRUPO ALEGA CANTABRIA,225:00,76,13,41,31.7,11,37,29.7,24,78,30.8,17,24,70.8,17,32,49,19,9,13,1,0,1,23,22,79
2341467,CLUB OURENSE BALONCESTO,225:00,80,24,48,50.0,5,20,25.0,29,68,42.6,17,26,65.4,7,35,42,14,7,14,0,1,1,22,23,82
2341468,UEMC REAL VALLADOLID BALONCESTO,200:00,70,13,31,41.9,8,24,33.3,21,55,38.2,20,30,66.7,14,22,36,8,4,9,8,1,1,15,25,83
2341468,HESTIA MENORCA,200:00,66,15,43,34.9,9,26,34.6,24,69,34.8,9,12,75.0,13,18,31,11,4,6,1,8,5,26,14,47
2341469,MELILLA CIUDAD DEL DEPORTE,176:05,54,13,29,44.8,8,24,33.3,21,53,39.6,4,5,80.0,5,20,25,14,2,13,0,2,0,15,13,47
2341469,BALONCESTO FUENLABRADA,200:00,87,20,38,52.6,11,26,42.3,31,64,48.4,14,15,93.3,9,27,36,22,8,9,2,0,1,16,18,114
2341470,HLA ALICANTE,200:00,54,11,31,35.5,6,35,17.1,17,66,25.8,14,16,87.5,11,21,32,8,8,16,3,2,2,18,17,37
2341470,UEMC REAL VALLADOLID BALONCESTO,200:00,75,20,37,54.1,9,27,33.3,29,64,45.3,8,16,50.0,10,31,41,15,10,17,2,3,2,18,18,83
2341471,HESTIA MENORCA,200:00,85,24,43,55.8,8,21,38.1,32,64,50.0,13,17,76.5,13,23,36,15,8,11,4,2,4,27,23,97
2341471,AMICS CASTELLÓ,200:00,65,17,39,43.6,3,15,20.0,20,54,37.0,22,34,64.7,11,16,27,11,4,14,2,4,2,23,27,53
2341472,CACERES PATRIMONIO DE LA HUMANIDAD,200:00,90,22,41,53.7,12,25,48.0,34,66,51.5,10,16,62.5,9,23,32,21,10,10,2,1,2,26,19,100
2341472,MELILLA CIUDAD DEL DEPORTE,167:46,60,17,32,53.1,4,15,26.7,21,47,44.7,14,16,87.5,2,14,16,10,4,11,0,2,0,15,19,55
2341473,LEYMA CORUÑA,200:00,119,29,35,82.9,13,29,44.8,42,64,65.6,22,24,91.7,9,21,30,28,8,12,0,0,0,30,22,141
2341473,GRUPO ALEGA CANTABRIA,200:00,90,24,40,60.0,6,23,26.1,30,63,47.6,24,34,70.6,12,10,22,15,8,15,0,0,1,23,30,84
2341474,ICG FORÇA LLEIDA,200:00,66,18,37,48.6,4,24,16.7,22,61,36.1,18,26,69.2,14,16,30,11,11,20,1,2,1,20,31,63
2341474,GRUPO URETA TIZONA BURGOS,200:00,86,17,32,53.1,13,31,41.9,30,63,47.6,13,19,68.4,15,22,37,24,11,19,2,1,3,33,20,89
2341475,BALONCESTO FUENLABRADA,200:00,64,19,44,43.2,5,23,21.7,24,67,35.8,11,15,73.3,11,27,38,9,6,11,1,5,0,23,20,57
2341475,LONGEVIDA SAN PABLO BURGOS,200:00,72,16,29,55.2,9,30,30.0,25,59,42.4,13,24,54.2,5,30,35,16,7,11,5,1,5,20,23,82
2341476,CLUB OURENSE BALONCESTO,200:00,68,13,27,48.1,11,19,57.9,24,46,52.2,9,21,42.9,9,22,31,22,7,18,1,3,0,14,24,87
2341476,RIOVERDE CLAVIJO,200:00,51,10,25,40.0,9,33,27.3,19,58,32.8,4,7,57.1,10,17,27,17,13,15,3,1,2,24,14,44
2341477,ALIMERKA OVIEDO BALONCESTO,200:00,81,13,32,40.6,14,33,42.4,27,65,41.5,13,17,76.5,13,12,25,19,5,13,1,3,1,26,20,70
2341477,GUUK GIPUZKOA BASKET,200:00,86,24,36,66.7,7,19,36.8,31,55,56.4,17,28,60.7,11,20,31,25,5,13,3,1,0,20,26,108
2341478,REAL BETIS BALONCESTO,200:00,77,14,35,40.0,12,27,44.4,26,62,41.9,13,16,81.3,12,21,33,15,5,18,0,0,1,24,16,65
2341478,MOVISTAR ESTUDIANTES,200:00,86,21,30,70.0,10,27,37.0,31,57,54.4,14,17,82.4,6,21,27,19,11,10,0,0,0,16,24,112
2341479,GRUPO URETA TIZONA BURGOS,200:00,109,21,35,60.0,14,22,63.6,35,57,61.4,25,30,83.3,9,20,29,16,6,16,1,4,2,23,26,121
2341479,ALIMERKA OVIEDO BALONCESTO,200:00,93,18,30,60.0,13,30,43.3,31,60,51.7,18,23,78.3,5,11,16,12,8,16,4,1,2,26,22,79
2341480,AMICS CASTELLÓ,200:00,81,24,51,47.1,5,19,26.3,29,70,41.4,18,29,62.1,12,23,35,19,8,11,3,3,2,18,26,91
2341480,LONGEVIDA SAN PABLO BURGOS,200:00,94,16,31,51.6,17,38,44.7,33,69,47.8,11,16,68.8,8,34,42,17,9,15,3,3,1,26,18,101
2341481,GUUK GIPUZKOA BASKET,200:00,81,27,48,56.3,5,17,29.4,32,65,49.2,12,20,60.0,18,26,44,13,5,13,0,1,1,21,21,89
2341481,BALONCESTO FUENLABRADA,200:00,70,22,33,66.7,6,27,22.2,28,60,46.7,8,15,53.3,4,13,17,8,3,8,1,0,2,21,21,52
2341482,RIOVERDE CLAVIJO,200:00,64,24,47,51.1,1,12,8.3,25,59,42.4,13,20,65.0,9,23,32,20,7,11,5,2,2,24,21,73
2341482,HESTIA MENORCA,200:00,55,11,34,32.4,6,16,37.5,17,50,34.0,15,23,65.2,11,21,32,10,6,17,2,5,2,21,24,50
2341483,MOVISTAR ESTUDIANTES,200:00,93,23,38,60.5,11,28,39.3,34,66,51.5,14,17,82.4,8,20,28,22,7,9,2,1,1,18,22,112
2341483,HLA ALICANTE,200:00,75,24,47,51.1,5,13,38.5,29,60,48.3,12,20,60.0,11,18,29,10,4,15,1,2,3,22,18,61
2341484,CLUB OURENSE BALONCESTO,200:00,73,15,33,45.5,11,24,45.8,26,57,45.6,10,18,55.6,12,24,36,21,5,17,2,0,0,20,24,85
2341484,CACERES PATRIMONIO DE LA HUMANIDAD,200:00,61,14,34,41.2,9,23,39.1,23,57,40.4,6,10,60.0,10,18,28,20,8,18,0,2,0,24,20,57
2341485,GRUPO ALEGA CANTABRIA,200:00,75,17,46,37.0,11,21,52.4,28,67,41.8,8,14,57.1,7,34,41,13,10,14,0,3,2,20,17,77
2341485,ICG FORÇA LLEIDA,200:00,63,17,38,44.7,5,26,19.2,22,64,34.4,14,21,66.7,7,26,33,12,9,13,3,0,3,18,20,60
2341486,UEMC REAL VALLADOLID BALONCESTO,200:00,94,23,42,54.8,12,24,50.0,35,66,53.0,12,19,63.2,12,19,31,15,5,6,2,2,1,18,23,108
2341486,LEYMA CORUÑA,200:00,111,17,28,60.7,21,33,63.6,38,61,62.3,14,24,58.3,4,20,24,25,2,8,2,2,2,23,18,118
2341487,MELILLA CIUDAD DEL DEPORTE,175:05,68,15,21,71.4,10,32,31.3,25,53,47.2,8,10,80.0,5,23,28,15,3,7,2,2,2,17,13,75
2341487,REAL BETIS BALONCESTO,200:00,87,21,32,65.6,10,30,33.3,31,62,50.0,15,23,65.2,6,23,29,18,6,5,2,5,2,17,20,101
2341488,HLA ALICANTE,200:00,89,18,37,48.6,14,28,50.0,32,65,49.2,11,14,78.6,12,22,34,22,12,14,2,1,3,19,17,107
2341488,GRUPO ALEGA CANTABRIA,200:00,79,17,34,50.0,13,29,44.8,30,63,47.6,6,8,75.0,9,19,28,21,4,16,1,2,0,17,19,84
2341489,HESTIA MENORCA,200:00,56,12,30,40.0,4,22,18.2,16,52,30.8,20,25,80.0,15,26,41,7,7,17,7,1,1,26,25,59
2341489,LEYMA CORUÑA,200:00,51,14,39,35.9,2,15,13.3,16,54,29.6,17,25,68.0,11,17,28,10,10,12,1,7,3,25,26,43
2341490,LONGEVIDA SAN PABLO BURGOS,200:00,94,18,30,60.0,14,30,46.7,32,60,53.3,16,23,69.6,5,22,27,20,9,6,1,1,4,24,19,105
2341490,UEMC REAL VALLADOLID BALONCESTO,200:00,69,21,36,58.3,4,24,16.7,25,60,41.7,15,25,60.0,12,23,35,12,3,16,1,1,3,19,24,64
2341491,CACERES PATRIMONIO DE LA HUMANIDAD,200:00,85,21,45,46.7,6,13,46.2,27,58,46.6,25,36,69.4,16,19,35,13,4,17,1,2,3,23,29,85
2341491,RIOVERDE CLAVIJO,200:00,78,23,43,53.5,7,21,33.3,30,64,46.9,11,18,61.1,12,16,28,19,8,16,2,1,2,30,23,71
2341492,ICG FORÇA LLEIDA,200:00,96,18,25,72.0,15,39,38.5,33,64,51.6,15,19,78.9,7,22,29,24,15,9,1,2,4,14,19,126
2341492,MELILLA CIUDAD DEL DEPORTE,181:34,53,12,23,52.2,8,21,38.1,20,44,45.5,5,7,71.4,6,23,29,14,4,19,2,1,1,16,11,52
2341493,MOVISTAR ESTUDIANTES,200:00,103,21,36,58.3,11,19,57.9,32,55,58.2,28,34,82.4,5,23,28,20,6,15,2,1,1,17,25,123
2341493,GRUPO URETA TIZONA BURGOS,200:00,85,24,40,60.0,9,29,31.0,33,69,47.8,10,14,71.4,8,16,24,19,9,10,1,2,1,27,15,76
2341494,BALONCESTO FUENLABRADA,200:00,85,22,39,56.4,6,25,24.0,28,64,43.8,23,30,76.7,10,24,34,19,5,9,0,1,2,21,25,95
2341494,AMICS CASTELLÓ,200:00,98,23,40,57.5,11,26,42.3,34,66,51.5,19,19,100.0,5,25,30,19,2,9,1,0,0,26,19,102
2341495,ALIMERKA OVIEDO BALONCESTO,200:00,87,18,36,50.0,9,23,39.1,27,59,45.8,24,29,82.8,12,22,34,18,5,10,2,0,1,23,24,100
2341495,CLUB OURENSE BALONCESTO,200:00,78,19,39,48.7,9,28,32.1,28,67,41.8,13,15,86.7,9,20,29,20,5,9,0,2,1,24,23,81
2341496,REAL BETIS BALONCESTO,200:00,81,19,38,50.0,9,24,37.5,28,62,45.2,16,20,80.0,7,18,25,17,9,14,3,1,0,23,17,77
2341496,GUUK GIPUZKOA BASKET,200:00,83,21,40,52.5,9,21,42.9,30,61,49.2,14,25,56.0,10,29,39,24,7,15,1,3,2,17,23,103
2341497,GRUPO URETA TIZONA BURGOS,200:00,92,23,37,62.2,5,19,26.3,28,56,50.0,31,42,73.8,12,25,37,15,5,16,1,0,3,22,30,103
2341497,CACERES PATRIMONIO DE LA HUMANIDAD,200:00,87,26,47,55.3,6,17,35.3,32,64,50.0,17,19,89.5,6,16,22,16,11,12,0,1,3,30,22,82
2341498,AMICS CASTELLÓ,200:00,83,15,37,40.5,12,27,44.4,27,64,42.2,17,23,73.9,13,29,42,18,16,15,4,2,1,21,24,108
2341498,ALIMERKA OVIEDO BALONCESTO,200:00,61,14,35,40.0,8,32,25.0,22,67,32.8,9,18,50.0,16,25,41,12,8,19,2,4,0,24,21,48
2341499,LEYMA CORUÑA,200:00,97,18,34,52.9,12,28,42.9,30,62,48.4,25,33,75.8,7,28,35,24,4,11,2,4,2,24,23,110
2341499,ICG FORÇA LLEIDA,200:00,81,17,34,50.0,12,36,33.3,29,70,41.4,11,16,68.8,7,21,28,19,11,10,4,2,1,23,24,88
2341500,GUUK GIPUZKOA BASKET,200:00,87,26,37,70.3,5,13,38.5,31,50,62.0,20,27,74.1,7,20,27,15,7,7,0,0,3,12,27,118
2341500,HESTIA MENORCA,200:00,79,22,33,66.7,10,22,45.5,32,55,58.2,5,8,62.5,5,14,19,6,6,12,0,0,2,27,11,56
2341501,RIOVERDE CLAVIJO,200:00,73,23,39,59.0,7,17,41.2,30,56,53.6,6,10,60.0,8,19,27,15,4,11,1,2,0,30,14,63
2341501,MOVISTAR ESTUDIANTES,200:00,77,14,24,58.3,9,23,39.1,23,47,48.9,22,30,73.3,7,14,21,13,5,11,2,1,1,14,30,91
2341502,CLUB OURENSE BALONCESTO,200:00,68,17,34,50.0,7,24,29.2,24,58,41.4,13,22,59.1,3,20,23,17,3,7,1,2,1,17,24,69
2341502,BALONCESTO FUENLABRADA,200:00,80,15,24,62.5,15,40,37.5,30,64,46.9,5,6,83.3,7,32,39,12,3,12,2,1,0,24,17,82
2341503,GRUPO ALEGA CANTABRIA,200:00,72,24,48,50.0,4,14,28.6,28,62,45.2,12,13,92.3,7,19,26,14,9,14,3,4,2,21,13,67
2341503,LONGEVIDA SAN PABLO BURGOS,200:00,84,15,39,38.5,13,24,54.2,28,63,44.4,15,19,78.9,14,25,39,12,8,15,4,3,2,14,21,100
2341504,UEMC REAL VALLADOLID BALONCESTO,200:00,72,20,38,52.6,8,33,24.2,28,71,39.4,8,12,66.7,19,32,51,18,3,13,3,0,4,23,20,84
2341504,REAL BETIS BALONCESTO,200:00,66,13,36,36.1,7,22,31.8,20,58,34.5,19,25,76.0,5,19,24,13,7,8,0,3,2,20,21,59
2341505,MELILLA CIUDAD DEL DEPORTE,177:26,59,14,23,60.9,5,28,17.9,19,51,37.3,16,23,69.6,8,21,29,16,10,13,1,0,1,22,19,60
2341505,HLA ALICANTE,200:00,73,14,35,40.0,9,22,40.9,23,57,40.4,18,26,69.2,10,25,35,13,5,15,0,3,2,22,26,73
2341506,HLA ALICANTE,200:00,71,11,34,32.4,11,32,34.4,22,66,33.3,16,21,76.2,9,16,25,14,12,10,4,2,0,20,23,70
2341506,GUUK GIPUZKOA BASKET,200:00,70,20,36,55.6,6,20,30.0,26,56,46.4,12,18,66.7,9,32,41,18,5,24,2,4,2,23,20,73
2341507,HESTIA MENORCA,200:00,50,17,44,38.6,3,21,14.3,20,65,30.8,7,8,87.5,15,15,30,4,7,15,2,6,2,27,16,21
2341507,CLUB OURENSE BALONCESTO,200:00,74,15,29,51.7,9,24,37.5,24,53,45.3,17,27,63.0,10,25,35,11,7,10,6,2,1,16,27,95
2341508,LONGEVIDA SAN PABLO BURGOS,200:00,83,15,29,51.7,12,27,44.4,27,56,48.2,17,22,77.3,5,27,32,21,11,13,2,0,5,17,22,107
2341508,RIOVERDE CLAVIJO,200:00,66,23,57,40.4,4,16,25.0,27,73,37.0,8,12,66.7,14,22,36,9,9,18,0,2,3,23,17,46
2341509,CACERES PATRIMONIO DE LA HUMANIDAD,200:00,84,20,43,46.5,9,28,32.1,29,71,40.8,17,22,77.3,12,27,39,16,3,7,2,2,1,21,20,89
2341509,LEYMA CORUÑA,200:00,81,26,51,51.0,6,25,24.0,32,76,42.1,11,16,68.8,11,26,37,16,5,5,2,2,1,21,21,87
2341510,ICG FORÇA LLEIDA,200:00,97,29,38,76.3,12,36,33.3,41,74,55.4,3,5,60.0,10,27,37,28,11,17,3,2,3,22,14,116
2341510,AMICS CASTELLÓ,200:00,82,22,50,44.0,5,24,20.8,27,74,36.5,23,27,85.2,15,20,35,17,10,13,2,3,2,15,22,89
2341511,BALONCESTO FUENLABRADA,200:00,55,14,36,38.9,4,27,14.8,18,63,28.6,15,23,65.2,11,24,35,8,1,5,2,1,0,23,24,44
2341511,MOVISTAR ESTUDIANTES,200:00,80,18,39,46.2,8,24,33.3,26,63,41.3,20,23,87.0,9,34,43,12,1,4,1,2,0,25,23,91
2341512,ALIMERKA OVIEDO BALONCESTO,200:00,71,19,34,55.9,9,24,37.5,28,58,48.3,6,16,37.5,7,22,29,18,4,10,1,1,0,17,19,75
2341512,MELILLA CIUDAD DEL DEPORTE,172:48,68,12,24,50.0,13,27,48.1,25,51,49.0,5,6,83.3,5,15,20,24,6,6,0,1,0,16,12,81
2341513,GRUPO ALEGA CANTABRIA,200:00,81,18,39,46.2,8,19,42.1,26,58,44.8,21,24,87.5,7,17,24,16,6,11,0,3,1,22,22,81
2341513,UEMC REAL VALLADOLID BALONCESTO,200:00,82,17,35,48.6,10,19,52.6,27,54,50.0,18,27,66.7,5,21,26,13,8,12,3,0,4,22,22,84
2341514,REAL BETIS BALONCESTO,200:00,84,18,34,52.9,11,24,45.8,29,58,50.0,15,22,68.2,11,25,36,16,7,21,2,1,1,23,25,90
2341514,GRUPO URETA TIZONA BURGOS,200:00,85,15,34,44.1,13,29,44.8,28,63,44.4,16,22,72.7,8,14,22,20,8,14,1,2,1,25,22,78
2341515,HLA ALICANTE,200:00,83,19,33,57.6,9,24,37.5,28,57,49.1,18,23,78.3,7,23,30,23,10,14,1,0,2,26,20,93
2341515,BALONCESTO FUENLABRADA,200:00,79,15,34,44.1,10,23,43.5,25,57,43.9,19,24,79.2,3,17,20,20,7,14,0,1,1,20,24,79
2341516,GRUPO URETA TIZONA BURGOS,200:00,93,21,43,48.8,10,21,47.6,31,64,48.4,21,28,75.0,8,23,31,12,13,9,1,0,1,22,26,105
2341516,GRUPO ALEGA CANTABRIA,200:00,84,17,35,48.6,10,23,43.5,27,58,46.6,20,21,95.2,5,22,27,13,4,16,0,1,1,26,20,74
2341517,AMICS CASTELLÓ,225:00,79,18,41,43.9,4,16,25.0,22,57,38.6,31,40,77.5,14,29,43,18,5,19,3,3,3,19,31,97
2341517,RIOVERDE CLAVIJO,225:00,72,18,46,39.1,8,25,32.0,26,71,36.6,12,18,66.7,10,20,30,13,9,10,3,3,2,31,19,54
2341518,LEYMA CORUÑA,200:00,88,14,35,40.0,16,29,55.2,30,64,46.9,12,14,85.7,10,21,31,20,5,13,4,2,1,25,12,86
2341518,ALIMERKA OVIEDO BALONCESTO,200:00,77,18,37,48.6,8,23,34.8,26,60,43.3,17,30,56.7,14,19,33,14,9,9,2,4,2,13,25,91
2341519,GUUK GIPUZKOA BASKET,200:00,88,33,48,68.8,5,11,45.5,38,59,64.4,7,11,63.6,6,28,34,19,9,14,0,0,2,15,17,113
2341519,CACERES PATRIMONIO DE LA HUMANIDAD,200:00,64,19,41,46.3,7,24,29.2,26,65,40.0,5,6,83.3,7,15,22,7,6,12,0,0,0,17,15,45
2341520,MOVISTAR ESTUDIANTES,200:00,81,15,25,60.0,10,21,47.6,25,46,54.3,21,26,80.8,9,24,33,17,7,13,2,1,0,16,28,113
2341520,HESTIA MENORCA,200:00,56,11,26,42.3,9,27,33.3,20,53,37.7,7,11,63.6,8,9,17,12,3,13,1,2,0,28,15,26
2341521,CLUB OURENSE BALONCESTO,200:00,84,24,34,70.6,6,22,27.3,30,56,53.6,18,30,60.0,10,21,31,23,5,13,3,0,4,19,26,102
2341521,REAL BETIS BALONCESTO,200:00,83,18,30,60.0,12,29,41.4,30,59,50.8,11,17,64.7,5,19,24,21,5,12,0,3,1,26,19,79
2341522,UEMC REAL VALLADOLID BALONCESTO,200:00,80,20,44,45.5,7,28,25.0,27,72,37.5,19,23,82.6,15,28,43,13,4,15,6,0,3,18,24,88
2341522,ICG FORÇA LLEIDA,200:00,74,19,43,44.2,10,26,38.5,29,69,42.0,6,13,46.2,8,18,26,18,3,13,0,6,2,24,18,55
2341523,MELILLA CIUDAD DEL DEPORTE,180:19,66,16,30,53.3,9,22,40.9,25,52,48.1,7,7,100.0,8,17,25,21,2,12,0,0,1,24,18,69
2341523,LONGEVIDA SAN PABLO BURGOS,200:00,92,12,27,44.4,18,32,56.3,30,59,50.8,14,21,66.7,5,21,26,19,6,7,0,0,1,22,25,103
2341524,HESTIA MENORCA,200:00,82,21,41,51.2,11,23,47.8,32,64,50.0,7,16,43.8,7,19,26,15,8,10,1,0,2,24,14,71
2341524,LONGEVIDA SAN PABLO BURGOS,200:00,90,20,37,54.1,10,19,52.6,30,56,53.6,20,28,71.4,8,21,29,14,4,13,0,1,2,14,24,100
2341525,GRUPO URETA TIZONA BURGOS,200:00,92,20,39,51.3,11,32,34.4,31,71,43.7,19,25,76.0,10,18,28,17,8,12,2,2,2,26,25,88
2341525,LEYMA CORUÑA,200:00,103,22,35,62.9,11,24,45.8,33,59,55.9,26,30,86.7,5,21,26,23,6,14,2,2,1,26,23,113
2341526,CACERES PATRIMONIO DE LA HUMANIDAD,200:00,75,21,46,45.7,6,22,27.3,27,68,39.7,15,21,71.4,8,21,29,12,7,9,2,2,1,17,16,68
2341526,HLA ALICANTE,200:00,84,22,36,61.1,8,25,32.0,30,61,49.2,16,17,94.1,4,27,31,10,5,10,2,2,1,17,17,90
2341527,GUUK GIPUZKOA BASKET,200:00,99,25,30,83.3,13,18,72.2,38,48,79.2,10,15,66.7,5,23,28,19,6,12,1,0,2,11,17,132
2341527,CLUB OURENSE BALONCESTO,200:00,65,16,37,43.2,10,25,40.0,26,62,41.9,3,4,75.0,10,5,15,5,6,14,0,1,1,17,11,34
2341528,ICG FORÇA LLEIDA,200:00,88,22,39,56.4,9,24,37.5,31,63,49.2,17,25,68.0,12,25,37,20,8,9,3,1,1,16,24,115
2341528,REAL BETIS BALONCESTO,200:00,75,15,32,46.9,10,27,37.0,25,59,42.4,15,16,93.8,7,17,24,14,7,12,1,3,0,24,16,66
2341529,RIOVERDE CLAVIJO,200:00,62,10,22,45.5,10,31,32.3,20,53,37.7,12,18,66.7,10,16,26,15,8,17,1,3,0,27,19,48
2341529,MELILLA CIUDAD DEL DEPORTE,176:36,55,16,30,53.3,2,11,18.2,18,41,43.9,17,23,73.9,9,22,31,10,10,13,3,1,1,18,24,73
2341530,MOVISTAR ESTUDIANTES,225:00,91,12,29,41.4,17,34,50.0,29,63,46.0,16,27,59.3,9,18,27,16,10,10,2,0,0,26,29,94
2341530,UEMC REAL VALLADOLID BALONCESTO,225:00,92,20,40,50.0,11,20,55.0,31,60,51.7,19,25,76.0,7,24,31,20,5,16,0,2,6,29,25,93
2341531,ALIMERKA OVIEDO BALONCESTO,200:00,81,18,28,64.3,7,31,22.6,25,59,42.4,24,32,75.0,12,28,40,18,8,13,5,1,0,26,29,100
2341531,BALONCESTO FUENLABRADA,200:00,60,14,36,38.9,5,19,26.3,19,55,34.5,17,27,63.0,9,21,30,10,7,15,1,5,1,30,26,43
2341532,GRUPO ALEGA CANTABRIA,200:00,91,22,40,55.0,11,25,44.0,33,65,50.8,14,19,73.7,5,26,31,18,11,12,2,1,1,23,19,100
2341532,AMICS CASTELLÓ,200:00,80,26,49,53.1,4,17,23.5,30,66,45.5,16,20,80.0,9,26,35,15,9,17,1,2,2,19,22,86
2341533,HLA ALICANTE,200:00,74,16,43,37.2,9,26,34.6,25,69,36.2,15,24,62.5,16,23,39,14,12,14,1,3,2,23,22,72
2341533,ICG FORÇA LLEIDA,200:00,79,16,31,51.6,12,31,38.7,28,62,45.2,11,18,61.1,17,23,40,17,4,17,3,1,0,23,21,83
2341534,LONGEVIDA SAN PABLO BURGOS,200:00,77,15,28,53.6,12,36,33.3,27,64,42.2,11,18,61.1,6,26,32,15,9,10,5,0,0,23,19,80
2341534,LEYMA CORUÑA,200:00,75,25,48,52.1,2,25,8.0,27,73,37.0,19,25,76.0,13,31,44,12,5,12,0,5,0,19,23,76
2341535,AMICS CASTELLÓ,200:00,68,17,37,45.9,8,23,34.8,25,60,41.7,10,16,62.5,4,30,34,24,5,12,2,2,1,21,19,78
2341535,MOVISTAR ESTUDIANTES,200:00,84,16,45,35.6,14,29,48.3,30,74,40.5,10,19,52.6,15,32,47,27,7,11,2,2,1,19,21,105
2341536,BALONCESTO FUENLABRADA,200:00,94,23,42,54.8,11,26,42.3,34,68,50.0,15,20,75.0,12,26,38,25,8,8,0,1,4,18,20,120
2341536,CACERES PATRIMONIO DE LA HUMANIDAD,200:00,67,18,35,51.4,8,27,29.6,26,62,41.9,7,13,53.8,4,23,27,14,1,13,1,0,2,20,18,53
2341537,CLUB OURENSE BALONCESTO,200:00,72,13,23,56.5,8,31,25.8,21,54,38.9,22,34,64.7,9,25,34,14,5,17,2,5,1,22,27,70
2341537,GRUPO URETA TIZONA BURGOS,200:00,79,26,47,55.3,5,18,27.8,31,65,47.7,12,17,70.6,10,24,34,19,12,12,5,2,3,27,22,93
2341538,ALIMERKA OVIEDO BALONCESTO,200:00,80,22,37,59.5,8,26,30.8,30,63,47.6,12,18,66.7,7,29,36,19,6,13,1,3,3,21,20,89
2341538,RIOVERDE CLAVIJO,200:00,59,20,44,45.5,3,18,16.7,23,62,37.1,10,19,52.6,11,21,32,12,6,13,3,1,0,20,21,52
2341539,GRUPO ALEGA CANTABRIA,200:00,75,22,37,59.5,4,22,18.2,26,59,44.1,19,25,76.0,7,22,29,21,8,8,2,2,2,20,19,87
2341539,MELILLA CIUDAD DEL DEPORTE,180:31,66,18,31,58.1,7,28,25.0,25,59,42.4,9,12,75.0,10,23,33,15,6,8,2,2,1,16,19,80
2341540,REAL BETIS BALONCESTO,200:00,88,18,29,62.1,11,22,50.0,29,51,56.9,19,22,86.4,6,24,30,16,10,12,0,0,1,22,25,110
2341540,HESTIA MENORCA,200:00,57,17,37,45.9,3,14,21.4,20,51,39.2,14,15,93.3,6,14,20,8,6,14,0,0,4,25,22,42
2341541,UEMC REAL VALLADOLID BALONCESTO,200:00,71,17,30,56.7,9,32,28.1,26,62,41.9,10,17,58.8,12,19,31,7,6,15,5,0,5,16,20,66
2341541,GUUK GIPUZKOA BASKET,200:00,65,19,37,51.4,5,20,25.0,24,57,42.1,12,15,80.0,9,23,32,12,9,16,0,5,3,20,16,62
2341542,HESTIA MENORCA,200:00,57,12,35,34.3,5,26,19.2,17,61,27.9,18,26,69.2,15,16,31,7,6,19,1,3,1,27,22,26
2341542,HLA ALICANTE,200:00,76,21,37,56.8,5,17,29.4,26,54,48.1,19,29,65.5,11,20,31,5,11,12,3,1,5,22,27,81
2341543,CACERES PATRIMONIO DE LA HUMANIDAD,200:00,60,24,44,54.5,2,21,9.5,26,65,40.0,6,17,35.3,15,28,43,10,4,19,3,4,1,16,21,56
2341543,LONGEVIDA SAN PABLO BURGOS,200:00,81,24,48,50.0,8,19,42.1,32,67,47.8,9,11,81.8,5,23,28,16,13,9,4,3,7,21,16,91
2341544,LEYMA CORUÑA,200:00,83,16,35,45.7,9,32,28.1,25,67,37.3,24,31,77.4,11,24,35,20,5,11,3,3,4,29,25,82
2341544,BALONCESTO FUENLABRADA,200:00,86,15,32,46.9,8,24,33.3,23,56,41.1,32,41,78.0,9,29,38,13,7,12,3,3,0,26,28,95
2341545,ICG FORÇA LLEIDA,200:00,90,22,33,66.7,13,32,40.6,35,65,53.8,7,12,58.3,7,31,38,26,10,6,3,1,2,16,14,124
2341545,CLUB OURENSE BALONCESTO,200:00,55,15,33,45.5,6,28,21.4,21,61,34.4,7,9,77.8,7,20,27,10,3,12,1,3,1,14,16,44
2341546,RIOVERDE CLAVIJO,200:00,56,16,37,43.2,5,23,21.7,21,60,35.0,9,13,69.2,10,20,30,11,7,9,3,2,1,18,13,50
2341546,GUUK GIPUZKOA BASKET,200:00,76,25,41,61.0,5,23,21.7,30,64,46.9,11,14,78.6,12,21,33,19,4,7,2,3,0,13,17,94
2341547,MOVISTAR ESTUDIANTES,200:00,101,26,41,63.4,11,23,47.8,37,64,57.8,16,22,72.7,11,27,38,28,6,9,3,1,5,16,22,140
2341547,GRUPO ALEGA CANTABRIA,200:00,61,18,33,54.5,6,23,26.1,24,56,42.9,7,8,87.5,5,16,21,18,4,15,1,3,0,22,16,51
2341548,REAL BETIS BALONCESTO,225:00,85,21,43,48.8,10,31,32.3,31,74,41.9,13,15,86.7,7,21,28,10,4,8,1,0,0,22,19,72
2341548,ALIMERKA OVIEDO BALONCESTO,225:00,94,20,38,52.6,11,29,37.9,31,67,46.3,21,24,87.5,9,29,38,17,2,10,1,1,0,19,22,106
2341549,UEMC REAL VALLADOLID BALONCESTO,200:00,89,18,33,54.5,13,24,54.2,31,57,54.4,14,24,58.3,9,23,32,17,6,15,1,3,3,18,24,100
2341549,AMICS CASTELLÓ,200:00,71,17,34,50.0,10,25,40.0,27,59,45.8,7,10,70.0,7,14,21,13,4,14,3,1,0,24,18,57
2341550,MELILLA CIUDAD DEL DEPORTE,191:23,79,24,33,72.7,8,26,30.8,32,59,54.2,7,8,87.5,9,25,34,20,3,10,1,0,1,13,15,101
2341550,GRUPO URETA TIZONA BURGOS,200:00,73,19,40,47.5,8,25,32.0,27,65,41.5,11,12,91.7,8,20,28,17,1,9,0,1,2,18,12,65
2341551,LONGEVIDA SAN PABLO BURGOS,200:00,98,16,30,53.3,15,27,55.6,31,57,54.4,21,22,95.5,6,23,29,17,3,12,1,0,2,20,20,109
2341551,HLA ALICANTE,200:00,95,22,41,53.7,13,25,52.0,35,66,53.0,12,15,80.0,4,16,20,12,7,5,0,1,5,20,20,95
2341552,GRUPO URETA TIZONA BURGOS,200:00,119,26,36,72.2,17,34,50.0,43,70,61.4,16,20,80.0,8,20,28,27,9,7,2,0,1,24,20,143
2341552,BALONCESTO FUENLABRADA,200:00,77,17,37,45.9,10,22,45.5,27,59,45.8,13,24,54.2,7,16,23,16,1,15,0,2,0,20,24,63
2341553,AMICS CASTELLÓ,200:00,88,19,39,48.7,7,18,38.9,26,57,45.6,29,38,76.3,9,18,27,26,1,9,3,2,3,20,28,104
2341553,REAL BETIS BALONCESTO,200:00,100,19,32,59.4,16,35,45.7,35,67,52.2,14,19,73.7,9,18,27,21,4,8,2,3,1,28,20,101
2341554,GUUK GIPUZKOA BASKET,225:00,84,18,39,46.2,13,30,43.3,31,69,44.9,9,15,60.0,11,17,28,25,8,10,0,4,0,19,23,95
2341554,LEYMA CORUÑA,225:00,91,27,39,69.2,8,30,26.7,35,69,50.7,13,15,86.7,9,30,39,25,4,13,4,0,1,23,19,110
2341555,RIOVERDE CLAVIJO,200:00,69,19,29,65.5,6,27,22.2,25,56,44.6,13,21,61.9,9,20,29,19,5,18,3,2,2,27,18,59
2341555,UEMC REAL VALLADOLID BALONCESTO,200:00,77,18,37,48.6,6,20,30.0,24,57,42.1,23,29,79.3,7,20,27,11,8,11,2,3,3,19,25,81
2341556,MOVISTAR ESTUDIANTES,200:00,75,16,31,51.6,9,28,32.1,25,59,42.4,16,20,80.0,11,26,37,15,7,15,0,3,2,21,21,81
2341556,ICG FORÇA LLEIDA,200:00,72,20,34,58.8,7,29,24.1,27,63,42.9,11,17,64.7,6,17,23,18,9,10,3,0,1,21,20,72
2341557,CLUB OURENSE BALONCESTO,200:00,59,13,35,37.1,7,38,18.4,20,73,27.4,12,16,75.0,17,31,48,14,1,9,2,2,0,19,20,59
2341557,MELILLA CIUDAD DEL DEPORTE,182:01,53,15,29,51.7,4,19,21.1,19,48,39.6,11,16,68.8,5,28,33,10,7,3,1,0,2,18,16,65
2341558,ALIMERKA OVIEDO BALONCESTO,200:00,78,22,37,59.5,7,29,24.1,29,66,43.9,13,24,54.2,13,20,33,18,6,9,1,2,1,17,21,83
2341558,HESTIA MENORCA,200:00,84,19,33,57.6,12,24,50.0,31,57,54.4,10,23,43.5,8,24,32,18,4,11,2,1,1,21,17,86
2341559,GRUPO ALEGA CANTABRIA,200:00,95,28,45,62.2,11,28,39.3,39,73,53.4,6,7,85.7,11,24,35,20,13,9,0,0,0,18,12,113
2341559,CACERES PATRIMONIO DE LA HUMANIDAD,200:00,75,21,38,55.3,8,21,38.1,29,59,49.2,9,14,64.3,9,19,28,15,7,16,0,0,2,12,18,80
2341560,HLA ALICANTE,200:00,83,19,40,47.5,8,21,38.1,27,61,44.3,21,28,75.0,14,22,36,12,9,15,3,3,3,18,27,96
2341560,ALIMERKA OVIEDO BALONCESTO,200:00,73,15,30,50.0,12,32,37.5,27,62,43.5,7,9,77.8,9,17,26,16,7,18,3,3,1,27,18,61
2341561,HESTIA MENORCA,200:00,77,16,33,48.5,8,24,33.3,24,57,42.1,21,24,87.5,11,19,30,9,8,16,4,2,4,22,21,75
2341561,GRUPO URETA TIZONA BURGOS,200:00,78,23,45,51.1,6,19,31.6,29,64,45.3,14,16,87.5,11,20,31,4,10,13,2,4,3,21,21,75
2341562,LONGEVIDA SAN PABLO BURGOS,200:00,105,28,43,65.1,12,28,42.9,40,71,56.3,13,17,76.5,9,37,46,25,11,11,2,1,0,19,19,143
2341562,CLUB OURENSE BALONCESTO,200:00,55,12,38,31.6,7,22,31.8,19,60,31.7,10,14,71.4,6,20,26,7,3,17,1,2,0,19,19,30
2341563,CACERES PATRIMONIO DE LA HUMANIDAD,200:00,79,21,39,53.8,10,34,29.4,31,73,42.5,7,12,58.3,12,15,27,14,8,7,0,1,0,22,19,71
2341563,UEMC REAL VALLADOLID BALONCESTO,200:00,87,22,37,59.5,9,22,40.9,31,59,52.5,16,18,88.9,7,25,32,13,4,11,1,0,1,19,22,99
2341564,AMICS CASTELLÓ,200:00,80,21,42,50.0,7,18,38.9,28,60,46.7,17,26,65.4,6,18,24,20,5,9,3,2,1,18,24,88
2341564,GUUK GIPUZKOA BASKET,200:00,90,27,42,64.3,9,22,40.9,36,64,56.3,9,16,56.3,11,26,37,26,5,12,2,3,0,25,17,105
2341565,LEYMA CORUÑA,200:00,100,18,32,56.3,15,30,50.0,33,62,53.2,19,22,86.4,9,13,22,24,8,11,4,3,0,22,25,118
2341565,RIOVERDE CLAVIJO,200:00,77,16,27,59.3,9,20,45.0,25,47,53.2,18,23,78.3,3,18,21,20,6,22,3,4,0,25,20,73
2341566,BALONCESTO FUENLABRADA,200:00,73,19,35,54.3,8,25,32.0,27,60,45.0,11,14,78.6,4,30,34,17,4,13,1,2,0,21,18,77
2341566,ICG FORÇA LLEIDA,200:00,75,15,26,57.7,11,35,31.4,26,61,42.6,12,22,54.5,4,19,23,22,8,7,2,1,2,18,20,80
2341567,REAL BETIS BALONCESTO,200:00,80,19,28,67.9,8,25,32.0,27,53,50.9,18,20,90.0,5,25,30,9,5,10,1,2,2,18,20,89
2341567,GRUPO ALEGA CANTABRIA,200:00,70,17,40,42.5,7,25,28.0,24,65,36.9,15,17,88.2,8,20,28,6,7,6,2,1,3,20,18,62
2341568,MELILLA CIUDAD DEL DEPORTE,176:04,68,12,27,44.4,11,24,45.8,23,51,45.1,11,13,84.6,9,20,29,19,6,7,1,0,0,17,14,83
2341568,MOVISTAR ESTUDIANTES,200:00,81,18,32,56.3,13,27,48.1,31,59,52.5,6,9,66.7,5,22,27,16,4,13,0,1,0,17,17,84
2341569,GRUPO URETA TIZONA BURGOS,200:00,80,17,48,35.4,12,34,35.3,29,82,35.4,10,13,76.9,25,24,49,19,13,20,1,1,3,22,18,82
2341569,AMICS CASTELLÓ,200:00,66,19,40,47.5,5,14,35.7,24,54,44.4,13,18,72.2,5,20,25,15,8,20,1,1,3,20,22,62
2341570,CACERES PATRIMONIO DE LA HUMANIDAD,200:00,64,21,38,55.3,1,14,7.1,22,52,42.3,19,32,59.4,6,33,39,11,5,10,1,0,1,21,24,70
2341570,REAL BETIS BALONCESTO,200:00,61,14,28,50.0,7,34,20.6,21,62,33.9,12,16,75.0,5,26,31,12,7,8,0,1,0,24,21,55
2341571,GUUK GIPUZKOA BASKET,200:00,80,24,46,52.2,6,20,30.0,30,66,45.5,14,19,73.7,20,22,42,8,3,14,1,1,2,18,19,80
2341571,LONGEVIDA SAN PABLO BURGOS,200:00,78,18,37,48.6,10,33,30.3,28,70,40.0,12,17,70.6,14,12,26,9,8,5,1,1,0,19,18,69
2341572,ICG FORÇA LLEIDA,200:00,90,18,40,45.0,13,28,46.4,31,68,45.6,15,20,75.0,10,21,31,15,1,8,5,8,1,15,19,96
2341572,ALIMERKA OVIEDO BALONCESTO,200:00,84,21,40,52.5,13,30,43.3,34,70,48.6,3,7,42.9,11,23,34,21,7,8,8,5,1,19,15,102
2341573,RIOVERDE CLAVIJO,200:00,58,13,33,39.4,6,25,24.0,19,58,32.8,14,21,66.7,13,19,32,8,6,13,4,1,0,25,19,43
2341573,BALONCESTO FUENLABRADA,200:00,67,17,37,45.9,5,16,31.3,22,53,41.5,18,23,78.3,8,25,33,8,7,11,1,4,1,20,25,74
2341574,MOVISTAR ESTUDIANTES,200:00,76,12,26,46.2,12,35,34.3,24,61,39.3,16,24,66.7,13,21,34,21,6,10,1,0,0,19,24,88
2341574,LEYMA CORUÑA,200:00,78,17,30,56.7,11,32,34.4,28,62,45.2,11,13,84.6,10,25,35,21,3,12,0,1,1,24,19,84
2341575,CLUB OURENSE BALONCESTO,200:00,77,20,37,54.1,8,21,38.1,28,58,48.3,13,19,68.4,12,24,36,18,0,17,1,1,2,21,15,73
2341575,HLA ALICANTE,200:00,68,16,41,39.0,9,24,37.5,25,65,38.5,9,12,75.0,10,18,28,12,8,11,1,1,3,18,21,66
2341576,GRUPO ALEGA CANTABRIA,200:00,95,18,26,69.2,14,26,53.8,32,52,61.5,17,18,94.4,4,19,23,29,10,16,4,1,2,26,22,120
2341576,HESTIA MENORCA,200:00,77,28,46,60.9,2,12,16.7,30,58,51.7,15,27,55.6,11,15,26,17,6,15,1,4,6,22,24,74
2341577,UEMC REAL VALLADOLID BALONCESTO,200:00,73,15,43,34.9,8,29,27.6,23,72,31.9,19,24,79.2,19,23,42,8,3,8,1,0,5,18,20,67
2341577,MELILLA CIUDAD DEL DEPORTE,189:22,74,16,33,48.5,11,29,37.9,27,62,43.5,9,12,75.0,8,23,31,17,4,7,0,1,1,18,17,80
2341578,HLA ALICANTE,200:00,94,17,39,43.6,10,26,38.5,27,65,41.5,30,37,81.1,10,24,34,11,10,15,0,2,2,24,29,94
2341578,GRUPO URETA TIZONA BURGOS,200:00,89,11,32,34.4,17,34,50.0,28,66,42.4,16,19,84.2,7,20,27,20,9,18,2,0,2,29,24,83
2341579,HESTIA MENORCA,200:00,86,24,42,57.1,9,21,42.9,33,63,52.4,11,12,91.7,11,20,31,14,8,9,1,0,1,30,19,89
2341579,CACERES PATRIMONIO DE LA HUMANIDAD,200:00,67,17,36,47.2,5,15,33.3,22,51,43.1,18,27,66.7,9,16,25,12,4,13,0,1,0,19,30,68
2341580,LONGEVIDA SAN PABLO BURGOS,200:00,87,27,46,58.7,7,28,25.0,34,74,45.9,12,13,92.3,12,18,30,12,10,9,0,0,3,18,16,87
2341580,MOVISTAR ESTUDIANTES,200:00,91,19,30,63.3,15,30,50.0,34,60,56.7,8,14,57.1,9,21,30,19,3,14,0,0,3,16,18,99
2341581,LEYMA CORUÑA,200:00,106,23,37,62.2,11,28,39.3,34,65,52.3,27,32,84.4,9,28,37,25,4,3,1,0,2,20,22,136
2341581,CLUB OURENSE BALONCESTO,200:00,77,17,37,45.9,10,28,35.7,27,65,41.5,13,19,68.4,8,20,28,21,2,10,0,1,0,22,20,72
2341582,GUUK GIPUZKOA BASKET,200:00,76,18,32,56.3,8,21,38.1,26,53,49.1,16,20,80.0,13,28,41,18,7,20,0,1,2,15,22,98
2341582,GRUPO ALEGA CANTABRIA,200:00,67,18,38,47.4,8,23,34.8,26,61,42.6,7,9,77.8,4,12,16,13,12,12,1,0,1,22,15,53
2341583,ICG FORÇA LLEIDA,200:00,79,21,45,46.7,6,22,27.3,27,67,40.3,19,23,82.6,14,29,43,13,10,12,2,2,3,19,23,95
2341583,RIOVERDE CLAVIJO,200:00,72,13,32,40.6,12,30,40.0,25,62,40.3,10,15,66.7,9,28,37,15,9,17,2,2,0,23,19,72
2341584,BALONCESTO FUENLABRADA,200:00,81,19,33,57.6,9,26,34.6,28,59,47.5,16,28,57.1,8,20,28,28,8,9,2,1,1,23,25,97
2341584,REAL BETIS BALONCESTO,200:00,71,15,33,45.5,9,24,37.5,24,57,42.1,14,23,60.9,7,22,29,15,5,14,1,2,1,26,23,62
2341585,ALIMERKA OVIEDO BALONCESTO,200:00,83,16,31,51.6,14,30,46.7,30,61,49.2,9,11,81.8,9,15,24,16,8,12,4,1,0,18,19,91
2341585,UEMC REAL VALLADOLID BALONCESTO,200:00,66,15,40,37.5,9,22,40.9,24,62,38.7,9,14,64.3,12,16,28,11,7,15,1,4,3,21,18,52
2341586,MELILLA CIUDAD DEL DEPORTE,200:00,76,17,34,50.0,11,32,34.4,28,66,42.4,9,15,60.0,7,27,34,20,10,8,1,0,0,19,17,87
2341586,AMICS CASTELLÓ,200:00,65,15,35,42.9,7,20,35.0,22,55,40.0,14,20,70.0,6,33,39,11,4,15,0,1,0,17,19,67
2341587,HESTIA MENORCA,200:00,67,20,34,58.8,5,21,23.8,25,55,45.5,12,16,75.0,5,17,22,14,9,11,4,1,2,20,18,69
2341587,ICG FORÇA LLEIDA,200:00,70,26,41,63.4,2,15,13.3,28,56,50.0,12,15,80.0,9,22,31,13,7,13,1,4,1,18,20,80
2341588,GRUPO URETA TIZONA BURGOS,200:00,110,26,38,68.4,13,25,52.0,39,63,61.9,19,22,86.4,2,21,23,17,9,6,0,2,2,22,23,127
2341588,LONGEVIDA SAN PABLO BURGOS,200:00,96,20,32,62.5,14,34,41.2,34,66,51.5,14,19,73.7,7,17,24,18,2,10,2,0,2,24,22,93
2341589,CACERES PATRIMONIO DE LA HUMANIDAD,200:00,86,23,43,53.5,8,17,47.1,31,60,51.7,16,25,64.0,14,27,41,9,3,12,3,1,2,20,22,94
2341589,ALIMERKA OVIEDO BALONCESTO,200:00,78,16,44,36.4,11,31,35.5,27,75,36.0,13,15,86.7,15,14,29,12,7,6,1,3,0,22,20,69
2341590,AMICS CASTELLÓ,200:00,74,17,43,39.5,8,20,40.0,25,63,39.7,16,23,69.6,7,27,34,16,2,14,2,1,0,21,25,73
2341590,LEYMA CORUÑA,200:00,83,26,41,63.4,5,29,17.2,31,70,44.3,16,22,72.7,10,28,38,13,3,10,1,2,3,25,21,79
2341591,MOVISTAR ESTUDIANTES,200:00,97,18,29,62.1,11,25,44.0,29,54,53.7,28,34,82.4,7,24,31,15,9,10,0,0,1,21,22,112
2341591,CLUB OURENSE BALONCESTO,200:00,56,19,32,59.4,3,24,12.5,22,56,39.3,9,19,47.4,6,21,27,8,7,13,0,0,1,22,21,40
2341592,GRUPO ALEGA CANTABRIA,200:00,71,12,32,37.5,12,28,42.9,24,60,40.0,11,19,57.9,13,17,30,11,9,19,1,2,1,29,23,53
2341592,RIOVERDE CLAVIJO,200:00,75,21,34,61.8,4,18,22.2,25,52,48.1,21,38,55.3,14,24,38,7,7,16,2,1,4,23,28,74
2341593,REAL BETIS BALONCESTO,200:00,97,22,36,61.1,12,26,46.2,34,62,54.8,17,25,68.0,9,23,32,14,4,9,0,0,1,23,25,104
2341593,HLA ALICANTE,200:00,78,12,25,48.0,11,32,34.4,23,57,40.4,21,27,77.8,10,21,31,12,4,12,0,0,5,25,23,71
2341594,UEMC REAL VALLADOLID BALONCESTO,200:00,87,15,32,46.9,13,29,44.8,28,61,45.9,18,30,60.0,10,25,35,12,4,14,1,1,2,27,26,79
2341594,BALONCESTO FUENLABRADA,200:00,72,12,31,38.7,11,28,39.3,23,59,39.0,15,22,68.2,9,22,31,7,6,15,1,1,1,26,27,60
2341595,MELILLA CIUDAD DEL DEPORTE,200:00,82,20,40,50.0,12,32,37.5,32,72,44.4,6,9,66.7,13,15,28,16,5,10,0,1,0,19,19,78
2341595,GUUK GIPUZKOA BASKET,200:00,93,21,29,72.4,13,31,41.9,34,60,56.7,12,12,100.0,8,27,35,19,6,13,1,0,1,19,19,115
2341596,HLA ALICANTE,200:00,86,23,39,59.0,7,24,29.2,30,63,47.6,19,22,86.4,16,20,36,20,14,22,6,4,4,26,22,100
2341596,AMICS CASTELLÓ,200:00,64,15,30,50.0,3,16,18.8,18,46,39.1,25,31,80.6,5,13,18,13,12,20,4,6,0,22,26,61
2341597,LONGEVIDA SAN PABLO BURGOS,200:00,82,19,32,59.4,8,35,22.9,27,67,40.3,20,27,74.1,14,17,31,10,5,10,1,1,2,19,27,80
2341597,REAL BETIS BALONCESTO,200:00,94,18,30,60.0,15,26,57.7,33,56,58.9,13,19,68.4,6,20,26,18,6,12,1,1,0,27,19,96
2341598,LEYMA CORUÑA,200:00,97,20,33,60.6,12,32,37.5,32,65,49.2,21,27,77.8,16,28,44,22,7,14,7,1,2,20,20,124
2341598,MELILLA CIUDAD DEL DEPORTE,200:00,82,23,40,57.5,10,33,30.3,33,73,45.2,6,10,60.0,9,15,24,20,8,10,1,7,0,22,19,78
2341599,GUUK GIPUZKOA BASKET,200:00,83,24,45,53.3,9,22,40.9,33,67,49.3,8,16,50.0,15,28,43,17,3,14,2,4,4,16,18,94
2341599,MOVISTAR ESTUDIANTES,200:00,85,20,42,47.6,12,30,40.0,32,72,44.4,9,12,75.0,9,19,28,9,8,10,4,2,2,18,16,79
2341600,ICG FORÇA LLEIDA,200:00,95,26,37,70.3,10,24,41.7,36,61,59.0,13,18,72.2,3,28,31,22,9,14,3,1,0,24,21,113
2341600,CACERES PATRIMONIO DE LA HUMANIDAD,200:00,71,22,45,48.9,4,16,25.0,26,61,42.6,15,24,62.5,6,22,28,16,7,14,1,3,0,21,24,68
2341601,RIOVERDE CLAVIJO,200:00,61,9,27,33.3,10,27,37.0,19,54,35.2,13,22,59.1,10,21,31,14,8,21,6,1,1,25,22,52
2341601,GRUPO URETA TIZONA BURGOS,200:00,78,17,35,48.6,8,25,32.0,25,60,41.7,20,25,80.0,8,22,30,14,8,13,1,6,1,22,24,80
2341602,BALONCESTO FUENLABRADA,200:00,75,15,36,41.7,7,26,26.9,22,62,35.5,24,28,85.7,16,16,32,15,7,13,1,5,1,24,27,76
2341602,HESTIA MENORCA,200:00,81,21,38,55.3,7,21,33.3,28,59,47.5,18,22,81.8,11,21,32,11,5,13,5,1,1,27,24,83
2341603,CLUB OURENSE BALONCESTO,200:00,99,21,32,65.6,14,27,51.9,35,59,59.3,15,19,78.9,8,21,29,25,5,13,5,2,0,21,19,120
2341603,UEMC REAL VALLADOLID BALONCESTO,200:00,77,16,29,55.2,11,27,40.7,27,56,48.2,12,17,70.6,5,13,18,17,9,9,2,5,1,19,21,82
2341604,ALIMERKA OVIEDO BALONCESTO,200:00,86,22,42,52.4,8,17,47.1,30,59,50.8,18,31,58.1,13,26,39,9,2,10,0,2,0,19,25,90
2341604,GRUPO ALEGA CANTABRIA,200:00,81,23,41,56.1,8,25,32.0,31,66,47.0,11,15,73.3,5,15,20,9,6,3,2,0,0,25,19,70
2341605,HESTIA MENORCA,200:00,90,28,46,60.9,5,18,27.8,33,64,51.6,19,20,95.0,11,16,27,10,6,7,3,3,6,17,17,97
2341605,ALIMERKA OVIEDO BALONCESTO,200:00,74,17,36,47.2,10,25,40.0,27,61,44.3,10,13,76.9,11,16,27,13,5,15,3,3,2,17,17,70
2341606,GRUPO URETA TIZONA BURGOS,200:00,72,15,36,41.7,6,29,20.7,21,65,32.3,24,27,88.9,13,25,38,12,7,14,1,5,0,26,23,66
2341606,ICG FORÇA LLEIDA,200:00,79,20,39,51.3,6,28,21.4,26,67,38.8,21,27,77.8,12,30,42,16,7,12,5,1,2,23,26,93
2341607,CACERES PATRIMONIO DE LA HUMANIDAD,200:00,68,21,47,44.7,6,23,26.1,27,70,38.6,8,9,88.9,9,17,26,3,7,6,1,3,1,22,16,49
2341607,GUUK GIPUZKOA BASKET,200:00,86,28,43,65.1,6,14,42.9,34,57,59.6,12,15,80.0,7,29,36,13,3,13,3,1,1,17,21,106
2341608,AMICS CASTELLÓ,200:00,77,17,33,51.5,7,20,35.0,24,53,45.3,22,31,71.0,7,28,35,13,4,19,3,4,2,22,26,79
2341608,BALONCESTO FUENLABRADA,200:00,73,18,44,40.9,8,30,26.7,26,74,35.1,13,15,86.7,14,19,33,15,11,11,4,3,4,26,21,70
2341609,RIOVERDE CLAVIJO,200:00,62,17,32,53.1,5,20,25.0,22,52,42.3,13,25,52.0,6,17,23,16,6,9,0,1,4,15,21,62
2341609,LONGEVIDA SAN PABLO BURGOS,200:00,79,22,38,57.9,9,20,45.0,31,58,53.4,8,13,61.5,7,28,35,15,1,12,1,0,1,21,15,81
2341610,MOVISTAR ESTUDIANTES,200:00,93,23,37,62.2,7,19,36.8,30,56,53.6,26,32,81.3,7,17,24,12,8,8,0,0,0,18,22,101
2341610,REAL BETIS BALONCESTO,200:00,87,22,36,61.1,8,23,34.8,30,59,50.8,19,25,76.0,10,19,29,8,4,13,0,0,0,22,18,76
2341611,GRUPO ALEGA CANTABRIA,200:00,81,19,38,50.0,9,25,36.0,28,63,44.4,16,24,66.7,7,15,22,14,6,8,1,2,2,32,25,66
2341611,LEYMA CORUÑA,200:00,83,24,45,53.3,3,18,16.7,27,63,42.9,26,36,72.2,15,28,43,15,5,14,2,1,4,26,32,94
2341612,UEMC REAL VALLADOLID BALONCESTO,200:00,69,22,38,57.9,5,22,22.7,27,60,45.0,10,20,50.0,8,12,20,16,7,13,1,4,5,20,21,58
2341612,HLA ALICANTE,200:00,84,21,30,70.0,10,28,35.7,31,58,53.4,12,19,63.2,8,26,34,15,5,17,4,1,5,22,20,89
2341613,MELILLA CIUDAD DEL DEPORTE,200:00,67,15,37,40.5,9,25,36.0,24,62,38.7,10,12,83.3,8,23,31,17,3,8,4,3,0,16,16,74
2341613,CLUB OURENSE BALONCESTO,200:00,81,12,29,41.4,16,38,42.1,28,67,41.8,9,11,81.8,10,30,40,19,3,6,3,4,2,16,16,99
2341614,HLA ALICANTE,200:00,88,21,42,50.0,8,30,26.7,29,72,40.3,22,28,78.6,19,21,40,14,10,12,1,1,1,23,25,94
2341614,CACERES PATRIMONIO DE LA HUMANIDAD,200:00,73,16,33,48.5,9,23,39.1,25,56,44.6,14,20,70.0,9,20,29,17,2,19,1,1,1,25,23,64
2341615,LONGEVIDA SAN PABLO BURGOS,200:00,88,17,30,56.7,12,36,33.3,29,66,43.9,18,27,66.7,8,31,39,19,5,10,2,1,2,23,24,98
2341615,GRUPO ALEGA CANTABRIA,200:00,69,23,55,41.8,4,15,26.7,27,70,38.6,11,19,57.9,10,25,35,8,4,7,1,2,2,24,21,56
2341616,GUUK GIPUZKOA BASKET,200:00,84,17,32,53.1,9,23,39.1,26,55,47.3,23,33,69.7,10,19,29,10,4,10,1,0,0,21,30,88
2341616,UEMC REAL VALLADOLID BALONCESTO,200:00,81,19,32,59.4,10,26,38.5,29,58,50.0,13,16,81.3,3,16,19,10,3,10,0,1,2,30,21,62
2341617,ICG FORÇA LLEIDA,200:00,83,20,35,57.1,9,39,23.1,29,74,39.2,16,22,72.7,8,27,35,18,5,5,7,3,3,27,20,85
2341617,LEYMA CORUÑA,200:00,85,22,42,52.4,8,25,32.0,30,67,44.8,17,28,60.7,7,40,47,25,2,8,3,7,2,20,27,113
2341618,MOVISTAR ESTUDIANTES,200:00,84,25,49,51.0,6,23,26.1,31,72,43.1,16,18,88.9,14,24,38,19,10,12,5,2,2,22,20,99
2341618,RIOVERDE CLAVIJO,200:00,59,17,36,47.2,5,25,20.0,22,61,36.1,10,18,55.6,9,23,32,15,8,18,2,5,1,21,20,50
2341619,BALONCESTO FUENLABRADA,200:00,93,17,33,51.5,13,35,37.1,30,68,44.1,20,26,76.9,16,21,37,21,9,7,0,2,2,17,25,117
2341619,MELILLA CIUDAD DEL DEPORTE,200:00,74,9,27,33.3,15,29,51.7,24,56,42.9,11,15,73.3,7,22,29,16,2,16,2,0,0,25,17,63
2341620,CLUB OURENSE BALONCESTO,200:00,61,18,39,46.2,4,21,19.0,22,60,36.7,13,19,68.4,11,19,30,8,3,11,0,3,2,19,24,52
2341620,HESTIA MENORCA,200:00,66,21,37,56.8,3,19,15.8,24,56,42.9,15,21,71.4,9,28,37,15,7,9,3,0,4,24,19,76
2341621,ALIMERKA OVIEDO BALONCESTO,200:00,60,19,37,51.4,3,27,11.1,22,64,34.4,13,24,54.2,10,19,29,7,9,14,0,2,1,23,28,43
2341621,GRUPO URETA TIZONA BURGOS,200:00,75,18,32,56.3,10,28,35.7,28,60,46.7,9,14,64.3,11,29,40,16,9,17,2,0,2,28,23,83
2341622,REAL BETIS BALONCESTO,200:00,98,19,34,55.9,17,33,51.5,36,67,53.7,9,15,60.0,8,19,27,20,15,13,5,0,2,19,16,112
2341622,AMICS CASTELLÓ,200:00,77,17,41,41.5,11,23,47.8,28,64,43.8,10,11,90.9,12,22,34,17,10,20,0,5,1,16,19,84
2341623,HESTIA MENORCA,200:00,67,19,39,48.7,7,20,35.0,26,59,44.1,8,10,80.0,13,21,34,12,3,15,1,3,3,24,17,60
2341623,MOVISTAR ESTUDIANTES,200:00,75,15,34,44.1,8,20,40.0,23,54,42.6,21,29,72.4,11,17,28,15,11,8,3,1,1,17,24,92
2341624,GRUPO URETA TIZONA BURGOS,200:00,101,21,42,50.0,14,26,53.8,35,68,51.5,17,19,89.5,8,22,30,15,6,17,4,3,1,31,22,95
2341624,GUUK GIPUZKOA BASKET,200:00,76,19,36,52.8,4,20,20.0,23,56,41.1,26,32,81.3,7,22,29,13,7,18,3,4,1,22,31,80
2341625,AMICS CASTELLÓ,200:00,92,20,36,55.6,11,30,36.7,31,66,47.0,19,23,82.6,12,22,34,18,11,17,2,0,1,18,20,103
2341625,ICG FORÇA LLEIDA,200:00,98,19,35,54.3,17,37,45.9,36,72,50.0,9,18,50.0,11,22,33,24,6,15,0,2,3,21,18,98
2341626,LEYMA CORUÑA,200:00,104,23,41,56.1,14,26,53.8,37,67,55.2,16,22,72.7,9,23,32,22,7,9,1,4,1,25,22,118
2341626,LONGEVIDA SAN PABLO BURGOS,200:00,103,19,43,44.2,15,34,44.1,34,77,44.2,20,23,87.0,17,19,36,16,6,10,4,1,3,22,23,110
2341627,RIOVERDE CLAVIJO,200:00,69,14,27,51.9,6,33,18.2,20,60,33.3,23,33,69.7,11,19,30,12,6,9,1,1,3,21,29,67
2341627,HLA ALICANTE,200:00,86,23,35,65.7,8,27,29.6,31,62,50.0,16,20,80.0,11,27,38,18,3,11,1,1,3,29,20,91
2341628,GRUPO ALEGA CANTABRIA,200:00,81,17,34,50.0,9,25,36.0,26,59,44.1,20,24,83.3,7,22,29,18,5,16,1,0,0,22,22,81
2341628,BALONCESTO FUENLABRADA,200:00,74,20,30,66.7,6,22,27.3,26,52,50.0,16,23,69.6,4,24,28,20,11,15,0,1,4,23,21,83
2341629,REAL BETIS BALONCESTO,200:00,72,15,33,45.5,10,25,40.0,25,58,43.1,12,15,80.0,8,29,37,15,7,15,0,1,2,18,21,83
2341629,CLUB OURENSE BALONCESTO,200:00,48,9,24,37.5,8,31,25.8,17,55,30.9,6,8,75.0,5,20,25,11,7,18,1,0,1,21,18,31
2341630,UEMC REAL VALLADOLID BALONCESTO,200:00,99,31,42,73.8,10,28,35.7,41,70,58.6,7,12,58.3,12,22,34,16,8,6,5,0,4,21,15,116
2341630,CACERES PATRIMONIO DE LA HUMANIDAD,200:00,72,25,45,55.6,4,20,20.0,29,65,44.6,10,17,58.8,9,14,23,10,2,10,0,5,2,16,21,59
2341631,MELILLA CIUDAD DEL DEPORTE,200:00,84,19,31,61.3,9,24,37.5,28,55,50.9,19,19,100.0,6,25,31,20,4,13,3,2,0,28,22,96
2341631,ALIMERKA OVIEDO BALONCESTO,200:00,81,8,21,38.1,17,38,44.7,25,59,42.4,14,24,58.3,10,19,29,14,3,12,2,3,0,22,27,78
2341632,HLA ALICANTE,200:00,90,17,30,56.7,13,31,41.9,30,61,49.2,17,24,70.8,9,17,26,24,7,9,0,0,2,19,23,104
2341632,MELILLA CIUDAD DEL DEPORTE,200:00,66,19,37,51.4,4,19,21.1,23,56,41.1,16,18,88.9,10,24,34,13,4,18,0,0,3,24,19,59
2341633,LONGEVIDA SAN PABLO BURGOS,200:00,90,16,32,50.0,15,25,60.0,31,57,54.4,13,17,76.5,1,25,26,24,7,12,0,2,3,19,19,105
2341633,HESTIA MENORCA,200:00,69,23,43,53.5,4,15,26.7,27,58,46.6,11,17,64.7,6,18,24,14,5,11,2,0,1,19,19,66
2341634,CACERES PATRIMONIO DE LA HUMANIDAD,200:00,81,24,42,57.1,8,24,33.3,32,66,48.5,9,15,60.0,10,18,28,14,8,12,0,2,0,25,21,75
2341634,AMICS CASTELLÓ,200:00,84,24,41,58.5,3,15,20.0,27,56,48.2,27,31,87.1,8,20,28,13,3,13,2,0,1,21,24,87
2341635,LEYMA CORUÑA,200:00,92,17,26,65.4,13,31,41.9,30,57,52.6,19,23,82.6,7,22,29,17,8,10,3,2,4,19,21,110
2341635,REAL BETIS BALONCESTO,200:00,78,18,37,48.6,10,28,35.7,28,65,43.1,12,13,92.3,8,19,27,19,6,8,2,3,1,21,19,84
2341636,GUUK GIPUZKOA BASKET,200:00,84,21,41,51.2,8,19,42.1,29,60,48.3,18,30,60.0,13,20,33,15,11,14,3,1,2,18,24,95
2341636,RIOVERDE CLAVIJO,200:00,66,20,40,50.0,4,23,17.4,24,63,38.1,14,21,66.7,13,21,34,6,4,15,1,3,0,24,18,44
2341637,ICG FORÇA LLEIDA,200:00,93,22,40,55.0,12,29,41.4,34,69,49.3,13,16,81.3,15,18,33,25,5,11,1,1,0,22,20,106
2341637,MOVISTAR ESTUDIANTES,200:00,79,20,34,58.8,7,24,29.2,27,58,46.6,18,24,75.0,10,19,29,12,6,11,1,1,0,20,22,81
2341638,BALONCESTO FUENLABRADA,200:00,79,15,28,53.6,9,20,45.0,24,48,50.0,22,31,71.0,6,25,31,16,3,15,1,0,3,26,29,85
2341638,GRUPO URETA TIZONA BURGOS,200:00,85,14,29,48.3,11,31,35.5,25,60,41.7,24,26,92.3,10,20,30,18,9,10,0,1,0,29,26,92
2341639,CLUB OURENSE BALONCESTO,225:00,88,26,43,60.5,6,25,24.0,32,68,47.1,18,34,52.9,12,19,31,13,9,13,2,3,1,24,28,82
2341639,ALIMERKA OVIEDO BALONCESTO,225:00,83,19,37,51.4,11,27,40.7,30,64,46.9,12,21,57.1,8,26,34,14,5,17,3,2,5,28,24,75
2341640,UEMC REAL VALLADOLID BALONCESTO,200:00,84,23,40,57.5,7,19,36.8,30,59,50.8,17,25,68.0,4,19,23,16,6,7,4,0,8,19,25,95
2341640,GRUPO ALEGA CANTABRIA,200:00,79,22,45,48.9,7,20,35.0,29,65,44.6,14,17,82.4,12,19,31,16,3,15,0,4,1,25,19,69
2341641,HESTIA MENORCA,200:00,89,23,48,47.9,8,17,47.1,31,65,47.7,19,24,79.2,15,17,32,12,4,8,2,1,0,16,21,97
2341641,GUUK GIPUZKOA BASKET,200:00,81,26,42,61.9,6,20,30.0,32,62,51.6,11,11,100.0,9,19,28,21,6,10,1,2,3,21,16,92
2341642,GRUPO URETA TIZONA BURGOS,200:00,85,22,42,52.4,7,25,28.0,29,67,43.3,20,28,71.4,14,20,34,16,8,9,1,2,0,20,28,97
2341642,CLUB OURENSE BALONCESTO,200:00,80,15,31,48.4,11,27,40.7,26,58,44.8,17,20,85.0,8,19,27,23,7,14,2,1,1,29,17,78
2341643,AMICS CASTELLÓ,200:00,80,20,39,51.3,7,29,24.1,27,68,39.7,19,27,70.4,11,26,37,16,9,14,3,3,3,33,25,74
2341643,UEMC REAL VALLADOLID BALONCESTO,200:00,84,26,45,57.8,3,20,15.0,29,65,44.6,23,34,67.6,13,26,39,15,6,14,3,3,5,25,33,94
2341644,RIOVERDE CLAVIJO,200:00,88,14,28,50.0,14,31,45.2,28,59,47.5,18,22,81.8,8,13,21,16,4,12,3,2,0,26,24,83
2341644,LEYMA CORUÑA,200:00,94,27,39,69.2,8,24,33.3,35,63,55.6,16,25,64.0,11,22,33,17,3,12,2,3,2,24,26,102
2341645,MOVISTAR ESTUDIANTES,200:00,57,15,41,36.6,4,25,16.0,19,66,28.8,15,27,55.6,12,24,36,12,7,14,0,5,1,20,28,47
2341645,LONGEVIDA SAN PABLO BURGOS,200:00,77,18,33,54.5,9,26,34.6,27,59,45.8,14,21,66.7,9,33,42,16,10,13,5,0,1,28,20,90
2341646,ALIMERKA OVIEDO BALONCESTO,200:00,73,24,40,60.0,4,21,19.0,28,61,45.9,13,19,68.4,11,25,36,18,4,9,3,2,2,17,21,90
2341646,ICG FORÇA LLEIDA,200:00,75,23,46,50.0,7,29,24.1,30,75,40.0,8,11,72.7,15,20,35,18,4,7,2,3,2,22,17,74
2341647,GRUPO ALEGA CANTABRIA,200:00,65,15,33,45.5,8,27,29.6,23,60,38.3,11,15,73.3,13,20,33,13,4,19,0,2,1,21,18,52
2341647,HLA ALICANTE,200:00,82,20,37,54.1,8,18,44.4,28,55,50.9,18,22,81.8,4,21,25,17,13,9,2,0,4,20,21,100
2341648,REAL BETIS BALONCESTO,200:00,79,19,32,59.4,8,25,32.0,27,57,47.4,17,23,73.9,12,17,29,12,9,14,3,1,0,26,20,76
2341648,BALONCESTO FUENLABRADA,200:00,78,18,32,56.3,7,22,31.8,25,54,46.3,21,31,67.7,10,17,27,13,6,12,1,3,2,20,26,80
2341649,MELILLA CIUDAD DEL DEPORTE,200:00,95,16,26,61.5,14,33,42.4,30,59,50.8,21,27,77.8,7,30,37,26,6,12,1,1,1,20,20,118
2341649,CACERES PATRIMONIO DE LA HUMANIDAD,200:00,79,19,40,47.5,8,27,29.6,27,67,40.3,17,22,77.3,12,20,32,17,6,13,1,1,0,20,20,77
2341650,HLA ALICANTE,200:00,67,19,43,44.2,6,23,26.1,25,66,37.9,11,12,91.7,14,18,32,14,5,9,2,4,3,20,19,68
2341650,HESTIA MENORCA,200:00,61,16,36,44.4,5,21,23.8,21,57,36.8,14,18,77.8,12,23,35,13,2,17,4,2,3,19,20,59
2341651,LONGEVIDA SAN PABLO BURGOS,250:00,104,25,42,59.5,9,30,30.0,34,72,47.2,27,37,73.0,9,24,33,24,7,15,0,0,5,28,29,106
2341651,GRUPO URETA TIZONA BURGOS,250:00,97,26,52,50.0,6,19,31.6,32,71,45.1,27,32,84.4,9,28,37,18,8,13,0,0,3,30,28,101
2341652,CACERES PATRIMONIO DE LA HUMANIDAD,200:00,71,16,36,44.4,6,14,42.9,22,50,44.0,21,31,67.7,8,20,28,11,7,16,1,1,0,17,28,75
2341652,GRUPO ALEGA CANTABRIA,200:00,73,15,34,44.1,11,27,40.7,26,61,42.6,10,13,76.9,7,18,25,13,11,14,1,1,2,28,17,60
2341653,LEYMA CORUÑA,200:00,114,19,32,59.4,14,30,46.7,33,62,53.2,34,35,97.1,11,24,35,21,3,9,2,1,3,28,27,135
2341653,MOVISTAR ESTUDIANTES,200:00,88,22,35,62.9,7,30,23.3,29,65,44.6,23,27,85.2,8,15,23,16,3,8,1,2,1,27,28,84
2341654,GUUK GIPUZKOA BASKET,200:00,92,28,47,59.6,9,22,40.9,37,69,53.6,9,11,81.8,14,30,44,14,8,20,2,1,2,22,18,102
2341654,AMICS CASTELLÓ,200:00,78,26,56,46.4,3,16,18.8,29,72,40.3,17,20,85.0,13,16,29,12,11,10,1,2,3,18,22,79
2341655,BALONCESTO FUENLABRADA,200:00,74,14,26,53.8,11,23,47.8,25,49,51.0,13,14,92.9,3,17,20,11,5,15,4,1,0,22,23,75
2341655,ALIMERKA OVIEDO BALONCESTO,200:00,69,14,30,46.7,10,30,33.3,24,60,40.0,11,15,73.3,9,17,26,16,8,11,1,4,0,23,21,67
2341656,CLUB OURENSE BALONCESTO,200:00,73,14,27,51.9,11,30,36.7,25,57,43.9,12,23,52.2,7,24,31,18,4,13,3,0,1,20,20,73
2341656,ICG FORÇA LLEIDA,200:00,80,21,45,46.7,8,21,38.1,29,66,43.9,14,20,70.0,9,31,40,20,9,10,0,3,0,20,20,96
2341657,REAL BETIS BALONCESTO,200:00,86,25,39,64.1,9,27,33.3,34,66,51.5,9,10,90.0,8,20,28,15,11,12,1,0,5,19,14,91
2341657,MELILLA CIUDAD DEL DEPORTE,200:00,70,13,30,43.3,9,17,52.9,22,47,46.8,17,21,81.0,5,21,26,8,6,23,0,1,1,14,19,63
2341658,UEMC REAL VALLADOLID BALONCESTO,200:00,86,27,43,62.8,4,19,21.1,31,62,50.0,20,29,69.0,10,18,28,12,11,13,0,1,3,23,23,84
2341658,RIOVERDE CLAVIJO,200:00,72,19,27,70.4,8,24,33.3,27,51,52.9,10,16,62.5,4,19,23,9,2,17,1,0,1,23,22,59
2341659,HESTIA MENORCA,200:00,76,14,25,56.0,12,31,38.7,26,56,46.4,12,13,92.3,10,16,26,20,13,14,3,2,1,23,18,88
2341659,UEMC REAL VALLADOLID BALONCESTO,200:00,57,13,34,38.2,6,18,33.3,19,52,36.5,13,22,59.1,16,19,35,12,6,21,2,3,4,18,23,54
2341660,GRUPO URETA TIZONA BURGOS,200:00,101,23,41,56.1,9,27,33.3,32,68,47.1,28,32,87.5,16,22,38,19,8,10,0,2,2,29,28,115
2341660,REAL BETIS BALONCESTO,200:00,80,18,40,45.0,6,21,28.6,24,61,39.3,26,35,74.3,9,14,23,7,8,12,2,0,3,28,28,62
2341661,AMICS CASTELLÓ,200:00,78,19,35,54.3,9,25,36.0,28,60,46.7,13,16,81.3,9,23,32,12,7,15,0,1,0,23,20,76
2341661,CLUB OURENSE BALONCESTO,200:00,81,14,25,56.0,14,34,41.2,28,59,47.5,11,22,50.0,9,19,28,21,8,13,1,0,1,20,21,85
2341662,LEYMA CORUÑA,200:00,67,14,32,43.8,8,31,25.8,22,63,34.9,15,21,71.4,8,23,31,13,6,11,4,4,5,23,18,58
2341662,GUUK GIPUZKOA BASKET,200:00,84,17,38,44.7,12,33,36.4,29,71,40.8,14,21,66.7,14,33,47,16,8,11,4,4,0,18,22,103
2341663,ICG FORÇA LLEIDA,200:00,77,17,40,42.5,10,25,40.0,27,65,41.5,13,16,81.3,11,27,38,18,9,13,4,4,1,15,20,97
2341663,LONGEVIDA SAN PABLO BURGOS,200:00,72,17,29,58.6,10,33,30.3,27,62,43.5,8,11,72.7,5,27,32,18,10,15,4,4,0,20,15,78
2341664,RIOVERDE CLAVIJO,200:00,78,22,36,61.1,8,27,29.6,30,63,47.6,10,12,83.3,9,20,29,17,8,8,1,1,3,18,17,89
2341664,CACERES PATRIMONIO DE LA HUMANIDAD,200:00,76,22,50,44.0,7,19,36.8,29,69,42.0,11,14,78.6,16,22,38,8,4,8,1,1,0,17,18,77
2341665,MOVISTAR ESTUDIANTES,200:00,98,18,30,60.0,12,23,52.2,30,53,56.6,26,31,83.9,2,27,29,16,4,9,1,2,0,23,27,115
2341665,BALONCESTO FUENLABRADA,200:00,83,18,29,62.1,12,32,37.5,30,61,49.2,11,19,57.9,8,20,28,14,3,11,2,1,1,27,23,76
2341666,ALIMERKA OVIEDO BALONCESTO,200:00,89,16,34,47.1,15,35,42.9,31,69,44.9,12,19,63.2,12,22,34,22,7,10,3,1,1,27,23,96
2341666,HLA ALICANTE,200:00,83,15,30,50.0,10,24,41.7,25,54,46.3,23,30,76.7,5,23,28,11,6,12,1,3,1,24,26,83
2341667,MELILLA CIUDAD DEL DEPORTE,200:00,71,17,35,48.6,9,29,31.0,26,64,40.6,10,16,62.5,7,22,29,19,13,12,0,0,1,22,20,74
2341667,GRUPO ALEGA CANTABRIA,200:00,84,19,30,63.3,10,26,38.5,29,56,51.8,16,23,69.6,5,27,32,21,8,17,0,0,1,20,22,96
2341668,HLA ALICANTE,200:00,75,12,26,46.2,9,25,36.0,21,51,41.2,24,26,92.3,4,25,29,21,12,14,4,1,1,17,22,100
2341668,MOVISTAR ESTUDIANTES,200:00,65,13,33,39.4,9,28,32.1,22,61,36.1,12,13,92.3,6,22,28,10,5,16,1,4,0,22,17,48
2341669,LONGEVIDA SAN PABLO BURGOS,200:00,99,20,28,71.4,16,40,40.0,36,68,52.9,11,18,61.1,13,26,39,25,9,8,3,1,2,20,16,124
2341669,MELILLA CIUDAD DEL DEPORTE,200:00,72,14,29,48.3,11,31,35.5,25,60,41.7,11,14,78.6,7,16,23,12,5,13,1,3,0,16,20,66
2341670,CACERES PATRIMONIO DE LA HUMANIDAD,200:00,63,20,43,46.5,4,12,33.3,24,55,43.6,11,19,57.9,8,30,38,5,6,10,1,3,1,23,21,62
2341670,HESTIA MENORCA,200:00,56,16,40,40.0,3,25,12.0,19,65,29.2,15,24,62.5,18,22,40,11,4,7,3,1,2,21,23,54
2341671,AMICS CASTELLÓ,200:00,72,21,42,50.0,3,14,21.4,24,56,42.9,21,39,53.8,6,22,28,22,3,12,3,1,0,23,27,70
2341671,GRUPO URETA TIZONA BURGOS,200:00,112,21,46,45.7,19,44,43.2,40,90,44.4,13,16,81.3,24,33,57,34,10,7,1,3,5,28,23,149
2341672,GUUK GIPUZKOA BASKET,200:00,87,19,39,48.7,14,28,50.0,33,67,49.3,7,9,77.8,10,28,38,15,4,11,2,3,1,18,20,101
2341672,ICG FORÇA LLEIDA,200:00,72,18,35,51.4,9,30,30.0,27,65,41.5,9,13,69.2,8,23,31,11,9,13,3,2,2,20,18,69
2341673,RIOVERDE CLAVIJO,200:00,78,19,38,50.0,7,20,35.0,26,58,44.8,19,29,65.5,10,28,38,20,2,13,0,1,1,17,26,92
2341673,ALIMERKA OVIEDO BALONCESTO,200:00,81,15,34,44.1,13,36,36.1,28,70,40.0,12,19,63.2,10,22,32,18,7,4,1,0,0,26,17,77
2341674,BALONCESTO FUENLABRADA,200:00,88,19,33,57.6,12,29,41.4,31,62,50.0,14,21,66.7,9,23,32,20,5,9,3,1,4,21,25,105
2341674,LEYMA CORUÑA,200:00,82,17,30,56.7,11,35,31.4,28,65,43.1,15,18,83.3,10,21,31,12,3,7,1,3,1,25,21,78
2341675,GRUPO ALEGA CANTABRIA,200:00,67,21,38,55.3,4,27,14.8,25,65,38.5,13,17,76.5,7,23,30,14,1,9,2,0,0,25,21,57
2341675,REAL BETIS BALONCESTO,200:00,78,19,36,52.8,7,21,33.3,26,57,45.6,19,24,79.2,8,27,35,18,6,9,0,2,8,22,24,94
2341676,UEMC REAL VALLADOLID BALONCESTO,200:00,81,20,41,48.8,6,21,28.6,26,62,41.9,23,27,85.2,12,29,41,8,1,10,1,0,5,17,23,88
2341676,CLUB OURENSE BALONCESTO,200:00,71,18,31,58.1,10,36,27.8,28,67,41.8,5,15,33.3,10,22,32,11,3,6,0,1,0,24,17,55
2341677,HESTIA MENORCA,200:00,84,21,39,53.8,10,21,47.6,31,60,51.7,12,18,66.7,8,21,29,13,7,13,3,2,0,20,19,87
2341677,GRUPO ALEGA CANTABRIA,200:00,68,20,38,52.6,5,18,27.8,25,56,44.6,13,18,72.2,8,16,24,10,7,13,2,3,0,19,20,63
2341678,LONGEVIDA SAN PABLO BURGOS,200:00,75,18,30,60.0,11,36,30.6,29,66,43.9,6,13,46.2,12,18,30,20,9,11,0,0,3,21,19,77
2341678,GUUK GIPUZKOA BASKET,200:00,70,22,43,51.2,4,20,20.0,26,63,41.3,14,18,77.8,13,26,39,10,5,12,0,0,1,19,21,73
2341679,GRUPO URETA TIZONA BURGOS,200:00,90,15,28,53.6,14,27,51.9,29,55,52.7,18,23,78.3,10,22,32,18,5,15,1,0,1,25,20,95
2341679,HLA ALICANTE,200:00,75,18,34,52.9,7,23,30.4,25,57,43.9,18,26,69.2,8,17,25,12,6,11,0,1,1,20,24,71
2341680,LEYMA CORUÑA,200:00,97,21,32,65.6,11,32,34.4,32,64,50.0,22,29,75.9,13,26,39,27,8,10,7,1,1,22,24,131
2341680,CACERES PATRIMONIO DE LA HUMANIDAD,200:00,80,18,39,46.2,11,26,42.3,29,65,44.6,11,16,68.8,8,17,25,18,2,13,1,7,1,24,22,70
2341681,ICG FORÇA LLEIDA,200:00,90,18,32,56.3,11,33,33.3,29,65,44.6,21,28,75.0,7,26,33,15,4,11,0,2,1,23,22,87
2341681,BALONCESTO FUENLABRADA,200:00,73,14,32,43.8,9,22,40.9,23,54,42.6,18,25,72.0,4,25,29,14,6,15,2,0,2,26,23,68
2341682,CLUB OURENSE BALONCESTO,200:00,92,26,37,70.3,10,27,37.0,36,64,56.3,10,16,62.5,6,23,29,13,6,4,3,1,3,23,19,101
2341682,MOVISTAR ESTUDIANTES,200:00,71,11,32,34.4,10,24,41.7,21,56,37.5,19,20,95.0,7,17,24,12,3,10,1,3,0,19,23,69
2341683,ALIMERKA OVIEDO BALONCESTO,200:00,80,20,35,57.1,10,38,26.3,30,73,41.1,10,10,100.0,7,23,30,18,4,9,1,1,4,22,19,78
2341683,AMICS CASTELLÓ,200:00,81,20,35,57.1,8,25,32.0,28,60,46.7,17,22,77.3,7,24,31,14,4,9,1,1,3,19,22,88
2341684,REAL BETIS BALONCESTO,200:00,94,28,36,77.8,10,26,38.5,38,62,61.3,8,13,61.5,5,16,21,15,13,11,0,1,8,23,21,101
2341684,RIOVERDE CLAVIJO,200:00,85,15,25,60.0,14,26,53.8,29,51,56.9,13,19,68.4,5,14,19,17,9,17,1,0,2,21,23,88
2341685,MELILLA CIUDAD DEL DEPORTE,200:00,80,14,32,43.8,11,27,40.7,25,59,42.4,19,24,79.2,12,24,36,22,5,13,4,0,1,19,21,97
2341685,UEMC REAL VALLADOLID BALONCESTO,200:00,81,20,40,50.0,10,24,41.7,30,64,46.9,11,12,91.7,8,18,26,17,5,10,0,4,2,22,18,80
2341686,HLA ALICANTE,200:00,73,18,33,54.5,10,30,33.3,28,63,44.4,7,12,58.3,10,17,27,17,9,12,0,2,4,23,16,67
2341686,REAL BETIS BALONCESTO,200:00,78,18,35,51.4,9,24,37.5,27,59,45.8,15,18,83.3,11,21,32,17,7,11,2,0,1,16,23,97
2341687,CACERES PATRIMONIO DE LA HUMANIDAD,200:00,64,19,43,44.2,5,22,22.7,24,65,36.9,11,22,50.0,16,35,51,7,3,13,1,2,1,21,23,63
2341687,GRUPO URETA TIZONA BURGOS,200:00,66,18,43,41.9,5,21,23.8,23,64,35.9,15,18,83.3,5,25,30,6,6,8,2,1,0,23,20,55
2341688,LEYMA CORUÑA,200:00,105,25,38,65.8,11,18,61.1,36,56,64.3,22,28,78.6,5,26,31,27,7,11,1,3,1,27,22,129
2341688,HESTIA MENORCA,200:00,73,14,29,48.3,10,28,35.7,24,57,42.1,15,32,46.9,9,11,20,14,5,12,3,1,0,22,27,58
2341689,GUUK GIPUZKOA BASKET,200:00,88,19,37,51.4,12,24,50.0,31,61,50.8,14,23,60.9,15,26,41,18,5,14,6,2,2,18,24,111
2341689,MELILLA CIUDAD DEL DEPORTE,200:00,80,17,40,42.5,10,34,29.4,27,74,36.5,16,17,94.1,14,20,34,9,5,11,2,6,1,24,18,65
2341690,RIOVERDE CLAVIJO,200:00,60,16,31,51.6,5,24,20.8,21,55,38.2,13,18,72.2,4,27,31,12,9,12,4,1,1,16,17,66
2341690,ICG FORÇA LLEIDA,200:00,72,15,34,44.1,10,26,38.5,25,60,41.7,12,16,75.0,8,28,36,12,6,11,1,4,2,17,16,76
2341691,MOVISTAR ESTUDIANTES,200:00,95,19,39,48.7,14,33,42.4,33,72,45.8,15,22,68.2,9,29,38,29,6,10,5,2,1,20,24,121
2341691,AMICS CASTELLÓ,200:00,79,19,39,48.7,9,24,37.5,28,63,44.4,14,20,70.0,3,24,27,19,7,11,2,5,0,25,20,77
2341692,BALONCESTO FUENLABRADA,200:00,76,16,33,48.5,10,34,29.4,26,67,38.8,14,18,77.8,8,29,37,12,3,5,5,4,2,17,21,87
2341692,CLUB OURENSE BALONCESTO,200:00,66,12,31,38.7,12,34,35.3,24,65,36.9,6,9,66.7,7,29,36,19,2,11,4,5,1,22,17,67
2341693,GRUPO ALEGA CANTABRIA,225:00,84,17,38,44.7,10,29,34.5,27,67,40.3,20,26,76.9,8,29,37,20,12,12,2,3,0,28,26,95
2341693,ALIMERKA OVIEDO BALONCESTO,225:00,83,16,33,48.5,12,27,44.4,28,60,46.7,15,31,48.4,9,26,35,17,7,18,3,2,1,26,27,80
2341694,UEMC REAL VALLADOLID BALONCESTO,200:00,91,23,43,53.5,8,21,38.1,31,64,48.4,21,26,80.8,9,20,29,15,3,8,3,0,5,23,23,95
2341694,LONGEVIDA SAN PABLO BURGOS,200:00,84,20,35,57.1,10,31,32.3,30,66,45.5,14,22,63.6,9,20,29,12,6,7,0,3,3,23,23,80
2341695,HESTIA MENORCA,200:00,68,18,34,52.9,6,22,27.3,24,56,42.9,14,16,87.5,11,20,31,10,2,12,2,0,0,17,20,70
2341695,RIOVERDE CLAVIJO,200:00,67,24,44,54.5,3,15,20.0,27,59,45.8,10,15,66.7,7,20,27,10,10,7,0,2,2,20,17,67
2341696,LONGEVIDA SAN PABLO BURGOS,250:00,109,32,51,62.7,6,33,18.2,38,84,45.2,27,33,81.8,16,25,41,20,13,14,0,0,2,24,26,119
2341696,CACERES PATRIMONIO DE LA HUMANIDAD,250:00,102,23,42,54.8,12,30,40.0,35,72,48.6,20,25,80.0,11,28,39,17,8,24,0,0,3,27,24,97
2341697,GRUPO URETA TIZONA BURGOS,200:00,90,22,39,56.4,11,28,39.3,33,67,49.3,13,16,81.3,10,23,33,16,10,15,1,0,3,29,20,89
2341697,MOVISTAR ESTUDIANTES,200:00,83,21,37,56.8,4,18,22.2,25,55,45.5,29,33,87.9,7,21,28,10,7,16,0,1,2,20,29,87
2341698,AMICS CASTELLÓ,200:00,90,18,40,45.0,12,28,42.9,30,68,44.1,18,23,78.3,11,23,34,20,5,11,2,5,2,16,20,101
2341698,MELILLA CIUDAD DEL DEPORTE,200:00,85,18,39,46.2,13,31,41.9,31,70,44.3,10,15,66.7,10,22,32,20,2,12,5,2,2,21,16,83
2341699,ICG FORÇA LLEIDA,200:00,81,21,35,60.0,8,32,25.0,29,67,43.3,15,19,78.9,14,16,30,24,13,8,1,3,5,23,22,98
2341699,UEMC REAL VALLADOLID BALONCESTO,200:00,56,16,35,45.7,3,21,14.3,19,56,33.9,15,21,71.4,17,23,40,10,4,23,3,1,3,22,23,48
2341700,BALONCESTO FUENLABRADA,200:00,77,16,28,57.1,9,25,36.0,25,53,47.2,18,25,72.0,7,18,25,8,7,16,4,1,0,22,25,73
2341700,HLA ALICANTE,200:00,71,16,34,47.1,9,23,39.1,25,57,43.9,12,16,75.0,9,22,31,9,7,14,2,4,5,26,22,66
2341701,CLUB OURENSE BALONCESTO,200:00,84,22,35,62.9,8,31,25.8,30,66,45.5,16,24,66.7,8,22,30,16,6,9,5,0,1,24,26,90
2341701,LEYMA CORUÑA,200:00,87,23,38,60.5,7,25,28.0,30,63,47.6,20,27,74.1,10,24,34,24,2,10,0,5,2,27,24,94
2341702,ALIMERKA OVIEDO BALONCESTO,200:00,86,23,39,59.0,9,29,31.0,32,68,47.1,13,25,52.0,8,23,31,16,9,7,2,2,1,23,21,87
2341702,REAL BETIS BALONCESTO,200:00,81,15,33,45.5,13,30,43.3,28,63,44.4,12,18,66.7,5,25,30,20,3,13,2,2,2,21,23,84
2341703,GRUPO ALEGA CANTABRIA,225:00,96,30,53,56.6,9,25,36.0,39,78,50.0,9,10,90.0,12,21,33,15,8,9,0,1,1,26,17,94
2341703,GUUK GIPUZKOA BASKET,225:00,106,20,38,52.6,15,27,55.6,35,65,53.8,21,31,67.7,7,27,34,21,6,12,1,0,2,17,25,124
2341704,HLA ALICANTE,200:00,91,20,38,52.6,12,24,50.0,32,62,51.6,15,19,78.9,5,20,25,23,9,10,3,2,4,19,20,108
2341704,CLUB OURENSE BALONCESTO,200:00,82,14,30,46.7,14,29,48.3,28,59,47.5,12,16,75.0,9,22,31,22,4,18,2,3,0,20,19,87
2341705,LONGEVIDA SAN PABLO BURGOS,200:00,91,23,39,59.0,13,36,36.1,36,75,48.0,6,8,75.0,13,23,36,24,11,10,3,1,3,20,16,110
2341705,AMICS CASTELLÓ,200:00,67,15,35,42.9,8,18,44.4,23,53,43.4,13,18,72.2,3,25,28,8,6,18,1,3,1,16,20,61
2341706,CACERES PATRIMONIO DE LA HUMANIDAD,200:00,71,16,33,48.5,10,30,33.3,26,63,41.3,9,15,60.0,11,18,29,14,5,14,0,1,0,17,18,63
2341706,BALONCESTO FUENLABRADA,200:00,97,25,35,71.4,12,28,42.9,37,63,58.7,11,15,73.3,8,28,36,10,11,11,1,0,0,18,17,113
2341707,LEYMA CORUÑA,200:00,97,21,34,61.8,12,33,36.4,33,67,49.3,19,29,65.5,14,27,41,17,9,19,4,2,2,25,27,107
2341707,GRUPO URETA TIZONA BURGOS,200:00,91,21,36,58.3,9,31,29.0,30,67,44.8,22,29,75.9,10,17,27,15,9,12,2,4,1,27,25,86
2341708,GUUK GIPUZKOA BASKET,200:00,67,18,28,64.3,8,28,28.6,26,56,46.4,7,10,70.0,9,24,33,12,5,14,2,1,3,14,20,78
2341708,ALIMERKA OVIEDO BALONCESTO,200:00,58,18,39,46.2,4,25,16.0,22,64,34.4,10,12,83.3,12,12,24,4,6,8,1,2,1,20,14,35
2341709,RIOVERDE CLAVIJO,200:00,99,22,29,75.9,11,21,52.4,33,50,66.0,22,30,73.3,5,21,26,25,4,13,1,2,3,20,26,123
2341709,GRUPO ALEGA CANTABRIA,200:00,84,21,38,55.3,10,33,30.3,31,71,43.7,12,18,66.7,14,13,27,16,9,9,2,1,0,26,20,77
2341710,REAL BETIS BALONCESTO,200:00,73,17,30,56.7,6,27,22.2,23,57,40.4,21,25,84.0,9,24,33,13,7,13,0,2,2,17,19,77
2341710,ICG FORÇA LLEIDA,200:00,74,21,36,58.3,6,24,25.0,27,60,45.0,14,16,87.5,6,22,28,12,6,11,2,0,3,19,16,73
2341711,UEMC REAL VALLADOLID BALONCESTO,200:00,73,14,34,41.2,11,22,50.0,25,56,44.6,12,22,54.5,11,20,31,14,1,9,0,1,3,22,23,70
2341711,MOVISTAR ESTUDIANTES,200:00,88,18,31,58.1,9,30,30.0,27,61,44.3,25,28,89.3,10,22,32,14,3,5,1,0,1,24,21,93
2341712,MELILLA CIUDAD DEL DEPORTE,200:00,74,24,36,66.7,4,14,28.6,28,50,56.0,14,16,87.5,4,13,17,13,7,12,1,1,1,20,21,77
2341712,HESTIA MENORCA,200:00,92,23,30,76.7,11,19,57.9,34,49,69.4,13,17,76.5,3,19,22,19,5,14,1,1,0,21,20,105
2341713,GRUPO URETA TIZONA BURGOS,200:00,89,20,41,48.8,13,27,48.1,33,68,48.5,10,11,90.9,11,30,41,22,5,12,1,2,2,17,18,111
2341713,MELILLA CIUDAD DEL DEPORTE,200:00,74,12,34,35.3,14,27,51.9,26,61,42.6,8,11,72.7,5,20,25,14,7,11,2,1,0,18,17,72
2341714,AMICS CASTELLÓ,225:00,83,21,42,50.0,7,20,35.0,28,62,45.2,20,28,71.4,11,18,29,21,10,17,0,1,2,18,25,91
2341714,HESTIA MENORCA,225:00,84,18,34,52.9,12,31,38.7,30,65,46.2,12,18,66.7,13,17,30,14,6,16,1,0,1,26,18,70
2341715,LEYMA CORUÑA,200:00,80,26,45,57.8,3,23,13.0,29,68,42.6,19,23,82.6,12,27,39,25,6,10,4,7,1,27,20,94
2341715,UEMC REAL VALLADOLID BALONCESTO,200:00,66,21,42,50.0,3,22,13.6,24,64,37.5,15,23,65.2,10,24,34,17,6,11,7,4,4,20,27,78
2341716,ICG FORÇA LLEIDA,200:00,91,26,41,63.4,5,15,33.3,31,56,55.4,24,33,72.7,8,26,34,20,7,13,3,1,0,19,24,113
2341716,HLA ALICANTE,200:00,77,15,35,42.9,12,32,37.5,27,67,40.3,11,16,68.8,9,18,27,14,7,13,1,3,6,24,19,63
2341717,MOVISTAR ESTUDIANTES,200:00,90,23,46,50.0,10,19,52.6,33,65,50.8,14,20,70.0,5,22,27,18,6,8,1,4,1,22,23,97
2341717,GUUK GIPUZKOA BASKET,200:00,81,21,42,50.0,8,21,38.1,29,63,46.0,15,24,62.5,8,27,35,18,6,10,4,1,1,23,22,90
2341718,BALONCESTO FUENLABRADA,200:00,78,21,40,52.5,5,26,19.2,26,66,39.4,21,34,61.8,10,25,35,16,6,6,1,1,1,23,29,83
2341718,RIOVERDE CLAVIJO,200:00,75,23,40,57.5,5,21,23.8,28,61,45.9,14,22,63.6,8,29,37,19,4,8,1,1,1,29,22,80
2341719,CLUB OURENSE BALONCESTO,200:00,65,23,37,62.2,3,26,11.5,26,63,41.3,10,21,47.6,6,29,35,15,6,11,4,2,2,25,22,63
2341719,GRUPO ALEGA CANTABRIA,200:00,72,15,36,41.7,5,21,23.8,20,57,35.1,27,30,90.0,4,30,34,9,2,9,2,4,0,22,23,71
2341720,ALIMERKA OVIEDO BALONCESTO,200:00,89,14,37,37.8,18,31,58.1,32,68,47.1,7,8,87.5,10,22,32,18,8,8,2,1,0,17,16,103
2341720,CACERES PATRIMONIO DE LA HUMANIDAD,200:00,71,16,30,53.3,11,25,44.0,27,55,49.1,6,11,54.5,6,23,29,10,4,14,1,2,0,16,17,69
2341721,REAL BETIS BALONCESTO,200:00,76,16,30,53.3,8,27,29.6,24,57,42.1,20,26,76.9,5,20,25,15,9,9,2,1,1,16,23,86
2341721,LONGEVIDA SAN PABLO BURGOS,200:00,88,18,33,54.5,14,28,50.0,32,61,52.5,10,15,66.7,8,25,33,20,5,12,1,2,0,23,16,94
2341722,HLA ALICANTE,200:00,84,17,31,54.8,9,27,33.3,26,58,44.8,23,30,76.7,11,22,33,14,6,14,2,1,4,24,28,90
2341722,LEYMA CORUÑA,200:00,74,19,26,73.1,6,25,24.0,25,51,49.0,18,27,66.7,3,21,24,15,5,18,1,2,3,30,23,59
2341723,HESTIA MENORCA,200:00,85,18,28,64.3,11,29,37.9,29,57,50.9,16,19,84.2,9,13,22,20,4,12,2,1,2,25,19,84
2341723,BALONCESTO FUENLABRADA,200:00,88,17,32,53.1,11,19,57.9,28,51,54.9,21,25,84.0,6,19,25,17,6,11,1,2,1,19,25,105
2341724,LONGEVIDA SAN PABLO BURGOS,200:00,87,18,36,50.0,12,32,37.5,30,68,44.1,15,19,78.9,10,31,41,21,9,8,1,1,4,22,18,105
2341724,ALIMERKA OVIEDO BALONCESTO,200:00,68,15,34,44.1,7,24,29.2,22,58,37.9,17,25,68.0,8,23,31,12,3,14,1,1,1,18,21,60
2341725,CACERES PATRIMONIO DE LA HUMANIDAD,200:00,71,21,45,46.7,6,23,26.1,27,68,39.7,11,15,73.3,9,24,33,9,7,13,2,5,2,28,23,59
2341725,CLUB OURENSE BALONCESTO,200:00,77,20,44,45.5,6,19,31.6,26,63,41.3,19,29,65.5,13,29,42,13,4,15,5,2,2,23,27,83
2341726,GUUK GIPUZKOA BASKET,225:00,93,20,46,43.5,9,28,32.1,29,74,39.2,26,29,89.7,16,23,39,12,6,14,1,4,0,19,26,96
2341726,REAL BETIS BALONCESTO,225:00,99,17,39,43.6,14,29,48.3,31,68,45.6,23,27,85.2,12,23,35,10,9,15,4,1,0,26,19,94
2341727,RIOVERDE CLAVIJO,200:00,93,28,51,54.9,10,29,34.5,38,80,47.5,7,7,100.0,14,20,34,12,7,11,1,5,0,21,15,88
2341727,AMICS CASTELLÓ,200:00,96,32,49,65.3,6,21,28.6,38,70,54.3,14,18,77.8,8,23,31,16,6,11,5,1,0,15,21,113
2341728,GRUPO ALEGA CANTABRIA,200:00,67,19,40,47.5,5,19,26.3,24,59,40.7,14,20,70.0,5,24,29,15,10,13,2,4,2,24,20,65
2341728,MOVISTAR ESTUDIANTES,200:00,81,20,43,46.5,7,21,33.3,27,64,42.2,20,24,83.3,11,25,36,22,6,13,4,2,1,20,23,98
